abat/o	abbot
abdik/i	to abdicate
abel/o	bee
abi/o	fir
abism/o	abyss
abiturient/o	top-form boy in secondary school, who obtained his leaving-certificate examination
ablativ/o	ablative
abnegaci/o	abnegation
abomen/o	abomination
abon/i	subscribe
abort/i	abort, miscarry
abrikot/o	apricot
abrupt/a	abrupt
absces/o	abscess
absint/o	absinth  AK
absolut/a	absolute
absorb/i	to occupy wholly, to absorb
abstin/i	to abstain
abstrakt/a	abstract
absurd/a	absurd
abund/a	abundant
acer/o	maple
acid/a	acid, sour  AK
aĉet/i	buy
adapt/i	to adapt
adept/o	adept
adici/i	to add up
adjektiv/o	adjective
adjutant/o	adjutant
administr/i	administer
administraci/o	administration
admir/i	admire
admiral/o	admiral
admiralitat/o	admiralty
admon/i	exhort
adopt/i	adopt
ador/i	adore
adrenalin/o	
adres/o	address
adult/i	commit adultery  AK
advent/o	Advent
adverb/o	adverb
advokat/o	counsel, advocate
aer/o	air
aerolit/o	aerolite
aeroplan/o	aeroplan
afabl/a	affable
afekt/i	be affected, mince  AK
afer/o	affair
afiks/o	affix
afiŝ/o	poster, placard
aflikt/i	to distress, grieve, afflict
aforism/o	aphorism, maxim
afrank/i	pay the postage
Afrik/o	Africa
afust/o	gun-carriage
ag/i	act
agac/i	setting on edge (teeth, etc.)  AK
agat/o	agate
agent/o	agent
agit/i	
agl/o	eagle
agoni/o	death-agony
agord/o	tune (vb.)  AK
agrabl/a	agreeable
agraf/o	clasp
agres/i	
agronom/o	
agronomi/o	husbandry
aĝ/o	age
aĝi/o	agio
aidos/o	
ajl/o	garlic  AK
akaci/o	acacia
akademi/o	academy
akapar/i	to corner
akar/o	mite (insect)  AK
akcel/i	accelerate
akcent/o	accent (tonic)  AK
akcept/i	accept
akcesor/a	accessory
akci/o	share
akcident/o	accident
akcipitr/o	hawk
akciz/o	excise
akir/i	acquire
aklam/i	to acclaim
akn/o	pimple
akompan/i	accompany
akord/o	accord
akr/a	sharp
akrid/o	grass-hopper
akrobat/o	
aks/o	axle
aksel/o	armpit
aksiom/o	axiom
akt/o	act, deed
aktiv/a	active
aktor/o	actor
aktual/a	present, of present interest
akupunktur/o	
akurat/a	punctual
akuŝ/i	be confined (in childbed) (intr.)  AK
akut/a	acute, sharp
akuz/i	to accuse
akuzativ/o	accusative
akv/o	water
akvafort/o	etching, aquafortis engraving
akvarel/o	aquarelle, water colours
akvari/o	aquarium
akvilegi/o	columbine
alabastr/o	alabaster
alarm/o	alarm
alaŭd/o	lark
alban/o	
albin/o	an albino
album/o	album
alcion/o	halcyon
ald/o	alto (voice)
ale/o	alley
alegori/o	allegory
Aleksandr/o	
alen/o	awl
alergi/o	
alfabet/o	alphabet
alg/o	
algebr/o	algebra
algoritm/o	
Alĝeri/o	
alĥemi/o	
ali/a	other
alibi/o	
aligator/o	alligator
aline/o	break (print)
alk/o	elk
alkemi/o	alchemy
alkohol/o	alcohol
alkov/o	alcove
almanak/o	almanack
almoz/o	alms
aln/o	alder
alo/o	aloe
alt/a	high
altar/o	altar
alte/o	marshmallow  AK
altern/i	alternate
alternativ/o	
alud/i	allude
alumet/o	match
alumini/o	aluminium
alun/o	alum
am/i	love
amar/a	bitter
amas/o	crowd, mass
amator/o	amateur
ambasad/o	embassy
ambasador/o	ambassador
ambici/o	ambition
ambos/o	anvil
ambr/o	ambergris
ambrozi/o	ambrosia
ambulanc/o	ambulance
ameb/o	
amel/o	starch
amend/i	
Amerik/o	America
ametist/o	
amfibi/oj	amphibium
amfiteatr/o	
amfor/o	amphora
amik/o	friend
amnesti/o	amnesty
amoniak/o	ammoniac
Amor-o	God of Love, Cupid
amortiz/i	
ampleks/o	extent, size  AK
ampol/o	phial, ampoule, bulb
amput/i	amputate
amulet/o	
amuz/i	amuse
anagal/o	scarlet pimpernel
anagram/o	
anakronism/o	
analiz/i	analyse
analog/a	
ananas/o	pine-apple  AK
anapest/o	
anarĥi/o	anarchy
anarki/o	anarchy
anas/o	duck
anatomi/o	anatomy
anĉ/o	
anĉov/o	anchovy
anekdot/o	anecdote
aneks/i	
anemon/o	
angelik/o	garden angelica
angil/o	eel
angin/o	quinsy
angl/o	
angor/o	anguish
angul/o	corner, angle
anĝel/o	angel
anilin/o	aniline
anim/o	soul
animal/o	animal (as opposed to vegetable or mineral)
aniz/o	anise (arom. plant)  AK
ankr/o	anchor
Ann/o	
anomali/o	
anonc/i	announce, advertize  AK
anonim/a	anonymous
anser/o	goose
Antarkt/o	
anten/o	antenna
antibiotik/o	
anticip/i	to anticipate
antikv/a	ancient, antique  AK
antilop/o	antelope
antimon/o	antimony
antipati/o	antipathy
antipod/o	antipodes
antitez/o	
antologi/o	
Anton/o	
antropolog/o	
antropologi/o	anthropology
anunciaci/o	Annunciation
anus/o	
aort/o	
aparat/o	apparatus
apart/a	separate, special  AK
apartament/o	apartments
aparten/i	belong
apati/o	apathy
apelaci/i	legal appeal, appellation
aper/i	appear
aperitiv/o	
apertur/o	aperture
apetit/o	appetite
api/o	smallage
aplaŭd/i	applaud
aplik/i	to apply
aplomb/o	self-assurance, imperturbability
apog/i	lean upon, support (trans.)  AK
apoge/o	apogee
apokrif/a	apocryphal
apolog/o	apologue
apopleksi/o	apoplexy
apostol/o	apostle
apostrof/o	
apotek/o	drug-store
apoteoz/i	
apozici/o	
apr/o	wild boar
April/o	April
aprob/i	approve
arab/o	
arabesk/o	
arane/o	spider
aranĝ/i	arrange
arb/o	tree
arbalest/o	crossbow
arbitr/a	arbitrary
arbitraci/o	arbitration
arbust/o	 shrub
arĉ/o	bow (Violin, etc.)  AK
ard/a	to be ardent, to glow
arde/o	heron
ardez/o	slate (substance)  AK
are/o	
aren/o	arena  AK
areometr/o	areometer
arest/i	arrest
argil/o	clay
argument/o	argue
arĝent/o	silver
arĥaik/a	archaic
arĥaism/o	
arĥeolog/o	archæologist
arĥeologi/o	archæology
arĥipelag/o	arcipelago
arĥitekt/o	architect
arĥitektur/o	architecture
arĥiv/o	archiv
ari/o	air
aristokrat/o	aristocrat
aristokrati/o	aristocracy (form of government)
aritmetik/o	arithmetic
ark/o	arch, bow
arkad/o	arcade
arkaik/a	archaic
arkaism/o	archaism, obsolete word
arkeolog/o	archæologist
arkeologi/o	archæology
arkipelag/o	arcipelago
arkitekt/o	architect
arkitektur/o	architecture
arkiv/o	archiv
Arkt/o	
arleken/o	harlequin
armo, arm/i	to arm  AK
arme/o	army
armen/o	
arnik/o	
arogant/a	arrogant
arom/o	aroma
arpeĝ/o	arpeggio
arsenik/o	arsenic
art/o	art
arteri/o	
artifik/o	artifice
artik/o	joint
artikol/o	article
artileri/o	artillery
artiŝok/o	artichoke
artrit/o	gout
as/o	ace
asbest/o	
asekur/i	insure
asemble/o	assembly
asert/i	assert
asesor/o	assessor
asfalt/o	asphalt
asign/i	assign
asimil/i	
asist/i	to assist (officially), to be in attendance (as experts or advisers), to support, to take part in
asoci/o	association
asonanc/o	
asparag/o	asparagus
aspekt/i	aspect
asperg/i	to sprinkle
aspid/o	asp, adder
aspir/i	to aspire
aspirin/o	
astm/o	asthma
astr/o	planet, star, heavenly body
astrolog/o	astrologer
astrologi/o	astrology
astronom/o	astronomer
astronomi/o	astronomy
atak/i	attack
atavism/o	
ateism/o	
ateist/o	atheist
atenc/i	make an attempt against, assault  AK
atend/i	wait, expect
atent/a	attentive
atest/i	attest, testify (certify)  AK
ating/i	attain, reach
Atlantik/o	Atlantic
atlas/o	satin
atlas/o	atlas
atlet/o	athlete
atmosfer/o	atmosphere
atom/o	atom
atribu/i	attribute
atribut/o	attribute
atripl/o	orach (bot.)  AK
atut/o	a trump (cards)  AK
aŭd/i	hear
aŭdac/a	audacious, bold, daring
aŭdienc/o	audience, interview
aŭditori/o	auditorium
aŭgur/i	to augur
Aŭgust/o	August
aŭkci/o	auction
aŭreol/o	aureola
aŭskult/i	listen
Aŭstrali/o	Australia
aŭt/o	car, automobile; (US) auto
aŭtentik/a	authentic
aŭtobiografi/	
aŭtobus/o	motor-bus, bus
aŭtograf/o	
aŭtokrat/o	
aŭtokrati/o	autocracy
aŭtomat/o	automaton
aŭtomobil/o	motor-car
aŭtonom/a	autonomous
aŭtor/o	author
aŭtoritat/o	authority
aŭtun/o	autumn, fall  AK
av/o	grandfather
avantaĝ/o	advantage
avar/a	covetous
avel/o	hazel-nut
aven/o	oats
aventur/o	adventure
avenu/o	avenue
avert/i	warn
aviad/o	aviation
avid/a	greedy, eager  AK
aviz/o	advice
avokad/o	
azen/o	ass
Azi/o	Asia
azil/o	
azot/o	nitrogen, azote  AK
babil/i	chatter
bacil/o	
bagatel/o	trifle, toy
bajonet/o	bayonet
bak/i	bake
bakteri/o	
bal/o	ball, dancing
bala/i	sweep (vb.)  AK
balad/o	
balanc/i	balance, swing
balast/o	ballast
balbut/i	stammer
baldaken/o	canopy
balen/o	whale
balet/o	ballet
balistik/o	
balkon/o	balcony
balon/o	
balot/i	to ballot
balustrad/o	balustrade
balzam/o	balsam
balzamin/o	
bambu/o	bamboo
ban/i	bath
banal/a	banal, hackneyed
banan/o	
band/o	band
bandaĝ/o	
banderol/o	paper band, wrapper
bandit/o	
bank/o	bank
banked/o	
bankier/o	banker
bankrot/i	become bankrupt
bant/o	knot (of ribbon, etc.)  AK
bapt/i	baptise
bar/o	bar, obstruct
barak/o	
barakt/i	throw oneself about, struggle  AK
barb/o	beard
barbar/o	barbarous
barbir/o	barber
barĉ/o	beetroot soup  AK
bard/o	bard
barel/o	keg, barrel
barelief/o	low-relief
barier/o	barrier
barikad/o	
bariton/o	baritone
bark/o	bark (ship)  AK
barometr/o	barometer
baron/o	baron
bas/o	bass (mus.)
basen/o	
bask/o	basque (of bodice, coat, etc.)  AK
baskul/o	
bast/o	bast, inner bark (tree)  AK
bastard/o	bastard
bastion/o	bulwark
baston/o	stick
bat/i	beat
batal/i	fight
batalion/o	battalion
bateri/o	battery
batist/o	
baz/o	basis, base
bazalt/o	
bazar/o	bazar  AK
bazilik/o	
bazilisk/o	basilisk
beb/o	baby
bed/o	bed (garden)
bedaŭr/i	regret, be sorry  AK
bek/o	beak
bel/a	beautiful
beladon/o	belladonna, deadly nightshade  AK
beletr/o	
beletristik/o	belles-lettres
belg/o	
bemol/o	
ben/i	bless
bend/o	tape, band
benk/o	bench
benzin/o	benzine
ber/o	berry
beril/o	
Berlin/o	
Bert/o	
best/o	animal, beast  AK
bet/o	red beet
beton/o	
betul/o	birch (tree)
bezon/i	need, want
bibli/o	Bible
bibliograf/o	
bibliografi/o	
bibliotek/o	library
bicikl/o	bicycle
bien/o	goods, estate
bier/o	beer
bifstek/o	beefsteak
bigot/o	bigot
bilanc/o	balance sheet
bilard/o	
bild/o	image, picture
bilet/o	ticket
bind/i	bind (books)
binokl/o	binocle, double eyeglass, opera-glass
biograf/o	
biografi/o	
biolog/o	
biologi/o	biology
bird/o	bird
biret/o	biretta, cap
Birm/o	
biskvit/o	biscuit
bismut/o	bismuth
bisturi/o	
bit/o	
bitum/o	bitumen
bivak/o	bivouac
bizon/o	
blank/a	white
blasfem/i	blasphemy
blat/o	blackbeetle, cockroach  AK
blazon/o	blazonry
blek/i	cry (of beasts)
blind/a	blind
blok/o	block, lump
blokad/o	blockade
blond/a	blond, fair  AK
blov/i	blow (trans.)  AK
blu/a	blue
bluf/i	
bluz/o	blouse
boa/o	boa (serpent)  AK
boac/o	
boat/o	boat, bark
boben/o	spool, bobin
boj/i	bark (dog’s)
bojkot/i	
boks/i	box (fight)
bol/i	boil (vb.)
Bolivi/o	
bomb/o	
bombard/i	bombard
bombast/o	bombast, turgidness
bombon/o	a sweet, bonbon  AK
bon/a	good
bor/i	bore (vb.)
boraks/o	borax
bord/o	shore
bordel/o	brothel
border/i	border, hem  AK
bors/o	bourse, exchange
bosk/o	bosk
bot/o	boot
botanik/o	botany
botel/o	bottle
bov/o	ox
bovl/o	bowl
bracelet/o	bracelet
bradip/o	
brak/o	arm
bram/o	bream
braman/o	
bran/o	bran
branĉ/o	branch
brand/o	brandy
brank/o	gill, fish-ear
brasik/o	cabbage
brav/a	valiant, brave
Brazil/o	
breĉ/o	
bred/i	to breed
brems/o	brake
bret/o	shelf, rack  AK
brid/o	bridle
brigad/o	
brik/o	brick
bril/i	shine
briliant/o	brilliant, gem  AK
brit/o	
broĉ/o	brooch
brod/i	embroider  AK
brog/i	scald
brokant/i	to broke
brokol/o	
brom/o	bromine
bronk/o	bronchial-tube
bronkit/o	
bronz/o	bronze
bros/o	brush
broŝur/o	pamphlet
brov/o	eye-brow
bru/i	noise
brul/i	burn (v. n.)
brun/a	brown
brust/o	breast
brut/o	head of cattle  AK
bub/o	lad, urchin  AK
bubal/o	buffalo  AK
buĉ/i	slaughter, butcher
bud/o	booth, shop
budĝet/o	budget
buduar/o	boudoir
buf/o	toad
bufed/o	buffet
buĝet/o	budget
buk/o	buckle, clasp  AK
buked/o	nosegay
bukl/o	curl, ringlet  AK
buks/o	box (tree)
bul/o	lump, clod, ball  AK
bulb/o	bulb, onion  AK
bulgar/o	
buljon/o	broth
bulk/o	manchet loaf, roll (bread)  AK
Bulonj/o	
bulten/o	bulletin
bulvard/o	boulevard
burd/o	bumble-bee, humble-bee  AK
burĝ/o	burgher
burĝon/o	bud
burlesk/a	
burnus/o	
burokrat/o	
bust/o	bust
buŝ/o	mouth
buŝel/o	bushel
buter/o	butter
butik/o	small shop  AK
buton/o	button
car/o	czar
ced/i	yield, give up
cedr/o	cedar
cejan/o	corn-flower
cel/o	aim
celeri/o	
celuloz/o	
cement/o	cement, lute
cend/o	cent (coin)
centigram/o	
centilitr/o	
centim/o	centime
centimetr/o	centimeter
centr/o	centre
central/o	centre (of activity), (generating) station, (telephone)exchange
centraliz/i	to centralize
cenzur/i	censure
cep/o	onion
ceramik-o	ceramics
cerb/o	brain
ceremoni/o	ceremony
cert/a	certain, sure
cerv/o	deer
ceter/a	rest, remainder
cic/o	
cidoni/o	quince
cidr/o	cider
cifer/o	a cipher, numerical figure  AK
cigan/o	gypsy
cigar/o	cigar
cigared/o	cigarette
cign/o	swan
cikad/o	cicada
cikatr/o	scar, cicatrice
cikl/o	
ciklon/o	
ciklop/o	
cikoni/o	stork
cikori/o	chicory
cikut/o	hemlock
cilindr/o	cylinder
cim/o	bug
cimbal/o	cymbal
cinabr/o	cinnabar
cinam/o	cinnamon
cindr/o	ash, cinder
cinik/a	
cipres/o	cypress
cir/o	shoe-polish
cirk/o	circus
cirkel/o	compasses (geom.)  AK
cirkl/o	circle
cirkonstanc/o	circumstance
cirkul/i	to circulate
cirkuler/o	circular
cirkumcid/i	
cirkumfleks/o	
cirkvit/o	circuit (electric)
cistern/o	cistern
cit/i	cite, quote, name  AK
citadel/o	citadel
citr/o	cithern, zithern  AK
citron/o	lemon
civil/a	civil (non-military)
civiliz/i	civilize  AK
civilizaci/o	civilisation
civit/o	city
col/o	inch
ĉagren/i	vex, annoy  AK
ĉam/o	wild goat
ĉambelan/o	chamberlain
ĉambr/o	room, chamber  AK
ĉampan/o	champagne
ĉampion/o	
ĉan/o	cock (of a gun)  AK
ĉap/o	cap, bonnet  AK
ĉapel/o	hat
ĉapitr/o	chapter
ĉar/o	car
ĉarlatan/o	charlatan
ĉarm/a	charm
ĉarnir/o	hinge  AK
ĉarpent/i	do carpenter’s work
ĉarpi/o	lint for a wound
ĉas/i	hunt
ĉasi/o	
ĉast/a	chaste
ĉek/o	cheque
ĉel/o	cell
ĉemiz/o	shirt
ĉen/o	chain
ĉeriz/o	cherry
ĉerk/o	coffin
ĉerp/i	draw (water, etc.)  AK
ĉes/i	cease, desist
ĉeval/o	horse
ĉevron/o	rafter
ĉiel/o	sky, heaven  AK
ĉif/i	crumple, tumble  AK
ĉifon/o	rag
ĉifr/o	cipher
ĉikan/i	cavil at, gossip mischievously  AK
ĉimpanz/o	
ĉin/o	
ĉiz/i	carve, chisel  AK
ĉokolad/o	chocolate
daktil/o	date (fruit)
dali/o	
dam/o	
damask/o	damask
dan/o	
danc/i	dance
dand/o	dandy
danĝer/o	danger
dank/i	thank
dat/o	date
dativ/o	dative
datur/o	thorn-apple, datura  AK
daŭr/o	last (intr.)  AK
debat/o	
debet/o	debit
dec/i	be fitting, proper  AK
Decembr/o	December
decid/i	decide
decigram/o	
decilitr/o	
decimal/a	
decimetr/o	
deĉifr/i	decipher
dediĉ/i	dedicate
dedukt/i	to deduce (deduction)
defend/i	defend
defi/i	
deficit/o	deficit
definitiv/a	definitive
degel/i	thaw
degener/i	degenerate
degrad/i	degrade
deĵor/i	be on duty, on service  AK
dekadenc/o	decadence
dekagram/o	
dekalitr/o	
dekametr/o	
dekan/o	dean
deklam/i	declaim
deklar/i	declare
deklaraci/o	declaration
deklinaci/o	decline (gram.)  AK
dekliv/o	declivity
dekolt/i	bare the neck
dekoraci/o	scenery, decorations
dekret/o	decree
dekstr/a	right-hand
deleg/i	delegate
delegaci/o	delegation
delfen/o	dolphin
delikat/a	delicate, fine
delir/i	be delirious, rave  AK
delt/o	
demagog/o	
demagogi/o	demagogy
demand/i	ask (a question)  AK
demografi/o	
demokrat/o	
demokrati/o	democracy
demon/o	demon
demonstraci/o	demonstration
demonstrativ/o	
denar/o	denarius (coin)  AK
dens/a	dense
dent/o	tooth
denunc/i	denounce
departement/o	
depeŝ/o	dispatch
depon/i	to deposit
deput/i	depute
deriv/i	to derive (tr.)
desegn/i	design, draw  AK
desert/o	dessert
despot/o	despot
destin/i	destine
detal/o	detailed, in detail  AK
detektiv/o	
determin/i	to determine
detru/i	destroy
dev/i	ought, must
deviz/o	device
dezert/o	a desert  AK
dezir/i	desire
dio, Di/o	God
diabet/o	
diabl/o	devil
diadem/o	diadem
diafan/a	diaphanous
diafragm/o	diaphragm
diagnoz/o	diagnosis
diagonal/o	diagonal
diakon/o	deacon
dialekt/o	dialect
dialektik/o	
dialog/o	dialogue
diamant/o	diamond
diametr/o	diameter
diant/o	pink
diapazon/o	
diboĉ/i	live in debauchery  AK
didaktik/o	
didelf/o	opossum
dies/o	
diet/o	diet
difekt/i	damage, injure
diferenc/i	differ
difin/i	define
difteri/o	diphtheria
difterit/o	diphtheria
diftong/o	diphthong
dig/o	embankment, dike  AK
digest/i	digest
dign/o	dignity
dik/a	thick, corpulent  AK
dikt/i	dictate
diktator/o	
dilem/o	
diletant/o	dilettante
diligent/a	diligent
diluv/o	deluge, flood
dimanĉ/o	Sunday
dimensi/o	dimension
dinamik/o	
dinamit/o	
dinamometr/o	
dinasti/o	dynasty
diplom/o	diploma
diplomat/o	diplomatist
diplomati/o	
dir/i	say
direkt/o	direct, steer  AK
direktor/o	director
disciplin/o	
disĉipl/o	disciple
disenteri/o	dysentery
disk/o	disk
diskont/i	discount
diskret/a	discreet
diskriminaci/i	
diskut/i	discuss
dispepsi/o	dyspepsia
dispon/i	dispose
disput/i	dispute
distanc/o	distance
distil/i	distil  AK
disting/i	distinguish
distr/i	distract
distribu/i	to distribute
distrikt/o	district
ditiramb/o	
divan/o	
diven/i	divine, guess
divers/a	various, diverse
divid/i	divide, share  AK
divizi/o	division
dizert/i	
dog/o	bulldog, mastiff
dogan/o	customs
dogm/o	
dok/o	dock, ship-basin
doktor/o	doctor
doktrin/o	doctrine
dokument/o	document
dolar/o	dollar
dolĉ/a	sweet
dolor/o	pain (vb.), hurt  AK
dom/o	house
domaĝ/i	pity (it is a pity)
domen/o	domino
don/i	give
donac/o	make a present
dorlot/i	spoil (vb.), pet (child)  AK
dorm/i	sleep
dorn/o	thorn
dors/o	back (body)  AK
dot/o	endow
doz/o	dose
dragon/o	dragoon
drak/o	dragon  AK
drakm/o	
dram/o	drama
drap/o	woollen cloth  AK
drapir/i	drape, hang (trans.)  AK
drast/a	
draŝ/i	thrash (corn)  AK
drat/o	wire
dres/i	train (soldier), tame (animal, etc.)  AK
drink/i	drink to excess, tipple  AK
driv/i	
drog/o	a drug  AK
dromedar/o	dromedary
dron/i	be drowning  AK
dualism/o	
dub/i	doubt
duel/o	duel
duet/o	duet
duk/o	duke
dukat/o	ducat
dung/i	hire, engage  AK
duŝ/o	shower-bath
eben/a	even, level  AK
ebon/o	ebony
ebri/a	drunk
ebur/o	ivory
Eden/o	Eden
edif/i	edify
edikt/o	edict
eduk/i	educate
edz/o	married person, husband
efekt/o	effect
efektiv/a	real, actual
efemer/o	ephemeral
efik/i	be effectual, work (intr.)  AK
egal/a	equal
egid/o	Ægis
egoism/o	egoism
egoist/o	egoist
eĥ/o	echo
ekip/i	
eklezi/o	the Church
eklips/o	eclipse
eklog/o	
ekologi/o	
ekonomi/o	economy
ekran/o	screen
ekscelenc/o	Excellency (title)  AK
eksces/o	
ekscit/i	excite
ekskluziv/a	
ekskomunik/i	
ekskrement/o	excrement
ekskurs/i	excursion
eksped/i	dispatch, forward  AK
eksperiment/o	experiment
eksplod/i	explode
ekspluat/i	
eksport/i	export
ekspozici/o	exhibition  AK
ekspres/a	express, messenger
ekstaz/o	ecstasy
eksterm/i	exterminate
ekstr/a	extra  AK
ekstrakt/o	extract
ekstrem/a	extreme
ekvaci/o	equation
Ekvador/o	
ekvator/o	equator
ekvilibr/o	equilibrium
ekzakt/a	exact (math.)
ekzamen/i	try, examine
ekzekut/i	execute, put to death  AK
ekzem/o	eczema
ekzempl/o	example
ekzempler/o	copy (of a book, etc.)  AK
ekzerc/i	practise, exercise (vb.)  AK
ekzil/i	banish, exile
ekzist/i	exist
elast/a	elastic  AK
elefant/o	elephant
elegant/a	elegant
elegi/o	elegy
elekt/i	choose
elektr/o	electricity
elektronik/o	electronics
element/o	element
elf/o	
eliksir/o	elixir
elips/o	ellipse
Elizabet/o	
elizi/i	elision
elokvent/a	eloquent
emajl/o	enamel
emancip/i	emancipate
embaras/o	embarrassment, perplexity  AK
emblem/o	emblem
embri/o	embryo
embusk/o	ambush
emerit/o	retired person, emeritus
emfaz/o	emphasis
Emili/o	
eminenc/o	Eminence (title)
eminent/a	eminent
emoci/o	emotion
empiri/o	empirics
emulsi/o	emulsion
enciklopedi/o	
endivi/o	
energi/o	energy
enigm/o	puzzle
enket/i	inquiry, inquest
entomolog/o	
entomologi/o	
entrepren/i	undertake
entuziasm/o	enthusiasm
enu/i	be bored, weary  AK
envi/i	envy
epidemi/o	epidemic
epiderm/o	epidermis
Epifani/o	
epigraf/o	epigraph
epigram/o	epigram
epilepsi/o	epilepsy
epilog/o	epilogue
episkop/o	bishop
epitet/o	epithet
epizod/o	episode
epok/o	epoch
epolet/o	epaulet, shoulder-strap
epope/o	epopee
erar/i	err, mistake
erik/o	heath
erinac/o	hedgehog
erizipel/o	erysipelas
ermen/o	ermine
ermit/o	hermit, solitary
Ernest/o	
erotik/a	erotic
erp/i	harrow (vb.)  AK
erudici/o	erudition
erupci/o	eruption
escept/i	except
esenc/o	essence
eskadr/o	squadron
eskap/i	to escape
eskort/i	
esper/i	hope
Esperant/o	
esplor/i	investigate, explore  AK
esprim/i	express (vb.)
est/i	be
establ/i	to establish
estetik/o	aesthetic
estim/i	esteem
esting/i	extinguish
eston/o	
estrad/o	estrade, platform
eŝafod/o	scaffold
etaĝ/o	story (of a house)  AK
etap/o	stage, halting-place, stopover
etat/o	statement (finance etc.)  AK
etend/i	extend
eter/o	ether
etern/a	eternal
etik/o	ethics
etiked/o	
etiket/o	etiquette
etimolog/o	
etimologi/o	
etiolog/o	
etiologi/o	etiology
etiop/o	
etn/o	
etnograf/o	
etnografi/o	
etnologi/o	
etos/o	
eŭfemism/o	
eŭkalipt/o	
Eŭkaristi/o	
eŭnuk/o	
eŭr/o	
Eŭrop/o	
Evangeli/o	Gospel
event/o	event
eventual/a	eventual
evident/a	evident
evit/i	avoid
evolu/i	
evoluci/o	evolution
ezofag/o	œsophagus
ezok/o	pike (fish)
fab/o	bean
fabel/o	tale, story
fabl/o	fable
fabrik/o	 (noto)
fac/o	face (of an object)
facet/o	facet
facil/a	easy
faden/o	thread (a)  AK
fag/o	beech-tree
fagot/o	bassoon, fagotto
fajenc/o	delft ware
fajf/i	whistle (vb.)  AK
fajl/i	file (vb.)  AK
fajr/o	fire
fak/o	department, compartment  AK
fakir/o	
faksimil/o	facsimile
fakt/o	fact
faktor/o	
faktur/o	invoice  AK
fakultat/o	faculty (of a University)
fal/i	fall
falang/o	phalanx
falbal/o	flounce, furbelow  AK
falĉ/i	mow, cut grass
faldo, fald/i	fold, pleat (vb.)  AK
falk/o	falcon
falsa, fals/i	falsify
fam/a	rumour, report, fame  AK
famili/o	family
familiar/a	
fanatik/a	
fand/i	melt, smelt (vb.)  AK
fanfar/o	
fanfaron/i	boast, brag
fantazi/o	fancy, fantasy
fantom/o	phantom, spectre  AK
far/i	do, make  AK
farb/o	paint
farĉ/o	
faring/o	pharynx  AK
farm/i	take on lease  AK
farmaci/o	pharmacy
fars/o	farce
fart/i	be (well or unwell)
farun/o	meal, flour  AK
fasad/o	façade
fask/o	bundle
fason/o	fashion, make, cut (of clothes, etc.)  AK
fast/i	fast (vb.)
fatal/a	destiny, fate
faŭk/o	jaw
fav/o	kind of ringworm  AK
favor/a	favorable
faz/o	phase
fazan/o	pheasant
fazeol/o	kidney bean
fe/o	
febr/o	fever
Februar/o	February
feĉ/o	lees, dregs  AK
feder/i	to federate
federaci/o	federation
fek/i	
fel/o	hide, fleece
feliĉ/a	happy
felieton/o	feuilleton
felt/o	felt (cloth)  AK
feminism/o	
feminist/o	
femur/o	thigh
fend/o	split
fenestr/o	window
feniks/o	
fenkol/o	fennel
fenomen/o	phenomenon
fer/o	iron
ferdek/o	deck (of ship)  AK
feri/o	holidays
ferm/i	shut
ferment/o	ferment
fervor/a	zeal, ardour
fest/i	celebrate  AK
festen/i	feast, banquet
festival/o	
feston/o	festoon
fetiĉ/o	fetish
feŭd/o	feud
fiakr/o	
fianĉ/o	betrothed person
fiask/o	fiasco
fibr/o	fibre
fid/i	rely upon, trust on
fidel/a	faithful
fier/a	proud
fig/o	fig
figur/o	figure, represent
fikci/o	fiction
fiksa, fiks/i	fix
fiktiv/a	fictitious
fil/o	son
filantrop/o	philanthroper
filantropi/o	philanthropy
fili/o	branch (of firm, of office)
filik/oj	fern
film/o	film
filolog/o	philologer
filologi/o	philology
filozof/o	philosopher
filozofi/o	philosophy
filtr/i	strain, filter
fin/i	finish, end (trans.)  AK
final/o	finale
financ/o	finance
fingr/o	finger
firm/a	firm
fisk/o	fisc
fistul/o	fistula
fiŝ/o	fish
fizik/o	physics
fiziolog/o	
fiziologi/o	physiology
fizionomi/o	physiognomy
fjord/o	
flag/o	flag
flagr/i	to blaze, flash, flare
flam/o	flame
flan/o	flawn
flanel/o	flannel
flank/o	side
flar/i	smell (vb.)
flat/i	flatter
flav/a	yellow
fleg/i	nurse, tend  AK
flegm/o	phlegm
fleks/i	bend
fleksi/o	inflection
flik/i	patch, repair
flirt/i	flirt, flutter
flok/o	flake, fluck
flor/o	bloom, flower (vb.)  AK
floren/o	
flos/o	float, raft
flu/i	flow
flug/i	fly (vb.)
fluid/o	fluid
flustr/i	to whisper
flut/o	flute
foir/o	fair (subst.)
foj/o	time (e. g. three times etc.)
fojn/o	hay
fok/o	seal (animal)
fokus/o	focus
foli/o	leaf, sheet (paper)  AK
folklor/o	
fon/o	background
fond/i	found
fonetik/o	phonetic
fonograf/o	
font/o	fountain
fontan/o	fountain  AK
forges/i	forget
forĝ/i	forge (smith’s work)  AK
fork/o	fork
form/o	form
formal/a	
format/o	size (of a book)
formik/o	ant
formul/o	formula
forn/o	stove, furnace, oven  AK
fort/a	strong
fortepian/o	pianoforte  AK
fortik/a	solid, durable, robust  AK
forum/o	
foso, fos/i	dig
fosfor/o	phosphorus
fost/o	post, stake
fot/o	
fotel/o	easy-chair, armchair, (fauteuil)
fotograf/i	photograph
fotografi/o	photography
frag/o	strawberry
fragment/o	fragment
fraj/o	spawn
frak/o	dress-coat
frakas/i	shatter, smash  AK
frakci/o	fraction
fraksen/o	ash (tree)  AK
fram/o	
framason/o	freemason
framb/o	raspberry
franc/o	
frand/i	revel in dainties, junket  AK
frangol/o	black alder, buck-thorn  AK
franĝ/o	fringe
frank/o	franc
frap/i	hit, knock (vb.)  AK
frat/o	brother
fraŭl/o	bachelor
fraz/o	phrase, sentence
fregat/o	frigate
fremd/a	strange, foreign
frenez/a	mad, crazy  AK
fresk/o	
freŝ/a	fresh
fring/o	chaffinch  AK
fringel/o	siskin
fripon/o	rogue, knave
fris/o	
frit/i	fry
frivol/a	frivolous
friz/i	friz, curl, dress (hair)  AK
fromaĝ/o	cheese
front/o	front
fronton/o	pediment
frost/o	frost
frot/i	rub
fru/a	early
frugileg/o	rook
frukt/o	fruit
frunt/o	forehead
frustr/i	
ftiz/o	phthisis, consumption
fuĝ/i	to flee
fuk/o	fucus
fulg/o	soot
fulm/o	lightning
fum/o	smoke
fund/o	bottom
fundament/o	foundation
funebr/o	mourning  AK
funel/o	funnel, mill-hopper
fung/o	fungus, mushroom  AK
funkci/o	function
funt/o	pound
furaĝ/o	forage
furi/o	Fury
furioz/a	furious, raging
furor/o	vogue
furunk/o	furuncle
furz/i	
fusten/o	fustian
fuŝ/i	bungle, blunder, botch  AK
fut/o	foot (measure)  AK
gad/o	hake, stockfish  AK
gaj/a	gay, glad
gajl/o	oak-apple
gajn/i	gain
gal/o	gall
galaksi/o	
galant/o	snowdrop
galanteri/o	haberdashery, trimmings  AK
galantin/o	
galer/o	galley
galeri/o	gallery
galon/o	galloon (gold or silver lace)  AK
galop/o	gallop
galoŝ/o	galosh  AK
gam/o	musical scale, gamut  AK
gamaŝ/o	gaiter
gangli/o	ganglion
gangren/o	gangrene
gant/o	glove
garaĝ/o	garage
garanti/i	guarantee (vb.)  AK
garb/o	sheaf, shock
gard/i	guard, watch over  AK
gardeni/o	gardenia
gargar/i	gargle, rinse  AK
garn/i	to garnish
garnitur/o	
garnizon/o	garrison
garol/o	jay
gas/o	gas
gast/o	guest
gaz/o	gauze
gazel/o	gazel
gazet/o	gazette, news-paper
gelaten/o	jelly
gem/o	
gen/o	
gencian/o	gentian
genealog/o	
genealogi/o	
generaci/o	generation
general/o	a general
geni/o	genius
genist/o	broom, genista
genitiv/o	genitive
genot/o	genet
genr/o	
gent/o	race, kind, genus
genu/o	knee
geodezi/o	
geograf/o	
geografi/o	geography
geolog/o	geologist
geologi/o	geology
geometr/o	
geometri/o	geometry
Georg/o	
gerani/o	geranium
german/o	
gerundi/o	gerund
gest/i	gesture
giĉet/o	
gigant/o	giant
gilotin/o	guillotine
gimnastik/o	gymnastics
gimnazi/o	grammarschool
gips/o	gypsum
girland/o	garland
gitar/o	guitar
glaci/o	ice (natural)  AK
glad/i	to iron  AK
gladiator/o	
glan/o	acorn
gland/o	gland, glandule
glas/o	a glass, tumbler  AK
glat/a	smooth, glossy (not rough)  AK
glav/o	sword
glazur/o	glaze
glicerin/o	glycerine
gliciriz/o	liquorice
glikoz/o	glucose
glim/o	mica  AK
glis/i	
glit/i	glide, skate, slide  AK
glob/o	globe
glor/o	glorify  AK
glu/o	glue
glukoz/o	glucose
glut/i	swallow (vb.)
gnom/o	
gobi/o	gudgeon
golf/o	gulf  AK
gondol/o	gondola
gorĝ/o	throat
goril/o	
gotik/a	
graci/a	slender
grad/o	degree
graf/o	earl, count
grafik/o	
grafit/o	
grafolog/o	
grafologi/o	graphology
grajn/o	a grain
gram/o	gram
gramatik/o	grammar
gramofon/o	gramophone
granat/o	pomegranate
grand/a	great, tall
grandioz/a	grand
granit/o	granite
gras/o	fat
grat/i	scratch
gratul/i	congratulate
grav/a	important
graved/a	pregnant
gravur/i	grave, engrave
greg/o	flock
grek/o	
gren/o	grain
grenad/o	grenade
gri/o	hulled grain (t.e. senŝeligita greno ia); coarse oatmeal (t.e. aveno duone muelita)  AK
grifel/o	slate-pencil  AK
gril/o	cricket (insect)
grimac/i	grimace
grimp/i	to climb
grinc/i	gnash, grind (of teeth, etc.)  AK
grip/o	
griz/a	grey
grog/o	
gros/o	gooseberry
groŝ/o	groschen (coin)  AK
grot/o	grotto  AK
grotesk/a	
gru/o	crane (bird)
grumbl/i	to grumble
grund/o	ground, earth (soil)
grup/o	group
gruz/o	gravel, grit
guberni/o	government (district)
gudr/o	tar
guf/o	owl
gujav/o	
gulden/o	florin
gum/o	gum (product)  AK
gurd/o	street organ, hurdy-gurdy  AK
gust/o	taste
gut/o	drop
gutaperk/o	
guvern/i	teach privately (act as tutor)  AK
gvardi/o	guard (subst.) (milit.)  AK
Gvatemal/o	
gvid/i	guide
Gvine/o	
ĝarden/o	garden
ĝem/i	groan
ĝemel/o	a twin
ĝen/i	inconvenience, bother, disturb  AK
ĝendarm/o	
ĝeneral/a	general
ĝentil/a	polite, courteous  AK
ĝerm/o	germ  AK
ĝib/o	hump
ĝin/o	
ĝir/i	to transfer (funds)
ĝiraf/o	giraffe  AK
ĝoj/i	rejoice, be glad  AK
ĝu/i	enjoy  AK
ĝust/a	right, exact, correct  AK
hajl/o	hail
hak/i	hew, chop
hal/o	hall (market, etc.)  AK
haladz/o	fume, exhalation  AK
halebard/o	
halt/i	come to a stop
hamak/o	hammock
hamstr/o	hamster
hangar/o	hangar, storage building
har/o	hair
hard/i	harden
harem/o	
haring/o	herring
harmoni/o	harmony
harmonik/o	
harmonium/o	
harp/o	harp
harpi/o	
harpun/o	harpoon
haŭt/o	skin (subst.)  AK
hav/i	have
haven/o	port, harbour
hazard/o	
hebre/o	Hebrew
heder/o	ivy
hegemoni/o	hegemony
heĝ/o	hedge
hejm/o	home
hejt/i	heat (vb.)
hekatomb/o	hecatomb
heksametr/o	
hektar/o	hectare
hektogram/o	
hektolitr/o	
hektometr/o	
hel/a	light, clear  AK
helic/o	screw, propeller
helik/o	snail
helikopter/o	helicopter
heliotrop/o	
help/i	help
Henriet/o	
hepat/o	liver
herb/o	grass
hered/i	inherit
herez/o	heresy
hermafrodit/a	
herni/o	hernia, rupture (med.)  AK
hero/o	hero  AK
herold/o	herald
hetman/o	
hezit/i	to hesitate
hiacint/o	hyacinth
hidr/o	
hidrarg/o	quicksilver
hidrofobi/o	hydrophobia
hidrogen/o	hydrogen
hidrostatik/o	
hidroterapi/o	
hien/o	hyena
hierarĥi/o	hierarchy
hierarki/o	hierarchy
hieroglif/o	
higien/o	hygiene
higrometr/o	
himn/o	hymn
hipertrofi/o	
hipnot/o	hypnotic sleep
hipodrom/o	
hipokrit/i	feign, play the hypocrite
hipopotam/o	hippopotamus
hipotek/o	mortgage
hipotez/o	hypothesis
hirt/a	bristly, rough
hirud/o	leech
hirund/o	swallow (bird)
hiskiam/o	henbane
hisop/o	
hispan/o	
histeri/o	hysterics
histori/o	history, story
histrik/o	porcupine
hoboj/o	oboe
hok/o	hook
hom/o	man (the species)  AK
homeopat/o	
homeopati/o	homeopathy
homonim/o	homonym
honest/a	honest
honor/o	honour (vb.)  AK
honorari/o	honorarium
hont/i	be ashamed  AK
hor/o	hour
horde/o	barley
horizont/o	horizon
horizontal/o	horizontal
horloĝ/o	clock
hormon/o	
horoskop/o	
hortensi/o	hydrangea
hortulan/o	ortolan (bird)  AK
hospital/o	hospital
hosti/o	host (consecrated wafer)  AK
hotel/o	hotel
huf/o	hoof
hum/o	humus, vegetable mould
human/a	humane
humer/o	
humid/a	damp, humid
humil/a	humble
humor/o	temper, humour  AK
hund/o	dog
hungar/o	
husar/o	hussar
huz/o	huso, sturgeon
ĥaos/o	chaos
ĥemi/o	chemistry
ĥimer/o	chimera
ĥirurg/o	surgeon
ĥirurgi/o	surgery
ĥoler/o	cholera
ĥor/o	chorus, choir
ibis/o	ibis
ide/o	idea
ideal/o	ideal
idealism/o	idealism
ident/a	identical
ideografi/o	ideography (noto)
ideologi/o	
idili/o	idyl
idiom/o	
idiot/o	idiot
idiotism/o	idiom (lingual peculiarity)
idol/o	idol
ignor/i	
iĥtiokol/o	isinglas
iks/o	
ileks/o	holly
ilumin/i	illuminate (lamps, lights, etc.)  AK
ilustr/i	illustrate
iluzi/o	illusion
imag/i	imagine
imit/i	imitate
imperativ/o	
imperfekt/o	
imperi/o	empire
imperial/o	roof (of a coach)
imperialism/o	imperialism
impertinent/a	impertinent
impet/i	to rush forward
implik/i	implicate
impon/i	impose
import/i	import
impost/o	impost
impres/o	impression
impresari/o	
improviz/i	improvize
impuls/o	impulsion
imun/a	immune
inaŭgur/i	to inaugurate
inaŭguraci/o	inauguration
incens/o	incense
incit/i	provoke, incite
indeks/o	index, alphabetical register
indiferent/a	indifferent
indig/o	indigo
indign/i	be indignant  AK
indiĝen/o	a native, indigene
indik/i	to indicate
indikativ/o	
individu/o	individual
indukt/i	to infer (induction)
indulg/i	be indulgent, be merciful, spare  AK
industri/o	industry
inert/a	inert, sluggish
infan/o	child
infanteri/o	infantry
infekt/i	infect
infer/o	hell
infinitiv/o	
inflaci/o	
inflam/o	inflammation
influ/i	influence
inform/i	inform
infuz/i	infuse
ingredienc/o	ingredient
ingven/o	groin
inĝenier/o	engineer
iniciat/i	initiate, start  AK
injekt/i	to inject
ink/o	ink
inklin/a	inclined, disposed  AK
inkluziv/a	
inkognit/o	incognito
inkvizici/o	Inquisition
inkvizitor/o	inquisitor
inokul/i	inoculate  AK
insekt/o	insect
insid/i	lay snares
insign/o	insignia, armorial bearings  AK
insist/i	insist
inspekt/i	
inspektor/o	inspector
inspir/i	inspire
instal/i	
instanc/o	
instig/i	instigate
instinkt/o	instinct
instituci/o	institution
institut/o	institute
instru/i	instruct, teach
instrukci/o	instruction
instrument/o	instrument
insul/o	island
insulin/o	
insult/i	abuse, revile  AK
intelekt/o	intellect
inteligent/a	intelligent
intenc/i	intend
intendant/o	
intens/a	intense, intensive
intereso, inte	interest
interjekci/o	interjection
intermit/i	intermit
intern/a	inner
interpelaci/i	to interpellate
interpret/i	interpret
interpunkci/o	punctuation
intervju/o	interview
intest/o	intestine
intim/a	intimate
intrig/i	intrigue
inund/i	to inundate
invad/i	to invade
invalid/o	invalid
invent/i	to invent
invers/a	inverse
invit/i	invite
ipsilon/o	
ir/i	go
Irak/o	
Iran/o	
irid/o	yellow flag
iris/o	iris
Irland/o	
ironi/o	irony
Island/o	
Israel/o	
istm/o	isthmus
ital/o	
izol/i	isolate
Izrael/o	
jaguar/o	jaguar
jak/o	jacket
Januar/o	January
japan/o	
jar/o	year
jasmen/o	jasmine
Jesu/o	Jesus
jezuit/o	Jesuit
jod/o	iodine
Johan/o	
Jork/o	
Jozef/o	
jubile/o	jubilee
jud/o	jew
judaism/o	judaism
jug/o	yoke
jugland/o	walnut
juĝ/i	judge  AK
juk/i	itch
Juli/o	July
jun/a	young
jung/i	couple, harness (vb.)
Juni/o	June
juniper/o	juniper
junk/o	rush (bot.)
jup/o	petticoat
jur/o	jurisprudence, science of law, law
just/a	just, righteous
juvel/o	jewel
ĵaket/o	jacket
ĵaluz/a	jealous
ĵargon/o	jargon
ĵaŭd/o	Thursday
ĵaz/o	
ĵet/i	throw
ĵoke/o	
ĵongl/i	juggle
ĵud/o	
ĵur/i	swear
ĵurnal/o	journal
kabal/o	cabala
kaban/o	hut
kabinet/o	1-e cabinet; 2-e cabinet; 3-e cabinet
kabl/o	cable, rope
kabriolet/o	
kaĉ/o	pap
kadavr/o	corpse
kadenc/o	cadence
kadet/o	cadet
kadr/o	frame (a)  AK
kaduk/a	decrepit, decayed (of things)  AK
kaf/o	coffee
kaĝ/o	cage
kahel/o	earthen (etc.) tile, flagstone (building)  AK
kaj/o	quay, wharf
kajer/o	unbound book, part (of same)  AK
kajut/o	cabin
kaka/o	cocoa
kakt/o	cactus
kal/o	corn (on the foot)
kalci/o	
kaldron/o	kettle
kalejdoskop/o	
kalendar/o	calendar
kalendul/o	marigold
kaleŝ/o	carriage
kalfatr/i	calk
kali/o	potassium
kalibr/o	
kalif/o	
kalik/o	chalice, cup  AK
kalikot/o	calico
kalk/o	lime
kalkan/o	heel
kalkul/i	calculate
kalomel/o	
kalson/o	drawers
kalumni/i	calumniate
kalv/a	bald, calvous
Kalvin/o	
kamarad/o	comrade, fellow
kambi/o	bill of exchange  AK
kame/o	
kamel/o	camel
kameli/o	camelia
kamen/o	fire-place
kamer/o	room (dark), camera  AK
kamfor/o	camphor  AK
kamion/o	lorry, truck
kamizol/o	waistcoat
kamlot/o	camlet (cloth)  AK
kamomil/o	camomile
kamp/o	field
kampanj/o	
kan/o	cane (reed)  AK
kanab/o	hemp
kanaben/o	linnet
Kanad/o	
kanajl/o	scoundrel, rascal  AK
kanal/o	channel
kanap/o	sofa, lounge
kanari/o	canary
kancelari/o	chancery
kancelier/o	chancellor
kancer/o	
kand/o	sugar-candy
kandel/o	candle
kandelabr/o	candelabrum
kandidat/o	candidate
kanguru/o	
kanibal/o	cannibal
kankr/o	crab
kanon/o	cannon, canon
kanonik/o	prebendary
kant/i	sing
kantarid/o	cantharide
kantat/o	cantata
kanton/o	
kantor/o	chanter, precentor  AK
kanvas/o	canvass (material)  AK
kanzon/o	(chanson), (little) song
kap/o	head
kapabl/a	capable
kapel/o	chapel
kapital/o	capital
kapitan/o	captain
kapitel/o	capital (of pillar)  AK
kapitulac/i	capitulate
kapon/o	capon
kapor/o	caper (berry)  AK
kaporal/o	corporal
kapot/o	greatcoat (with cape)  AK
kapr/o	goat
kapreol/o	roe, roe-buck
kapric/a	caprice, whim
kapsik/o	
kapsul/o	capsule
kapt/i	catch
kapucen/o	capuchin friar
kapuĉ/o	cowl, hood  AK
kar/a	dear
karaben/o	carabine
karaf/o	caraffe, decanter
karakter/o	character
karakteriz/i	characterize
karambol/i	to cannon at billiards
karamel/o	
karas/o	crucian (fish)  AK
karat/o	carat
karavan/o	caravan
karb/o	coal
karbon/o	carbon
karcer/o	dungeon
kard/o	thistle
kardel/o	thistle-finch
kardinal/o	
kares/i	caress
karier/o	career
karikatur/o	
kariofil/o	clove
kariol/o	cariole
karmin/o	carmine
karn/o	flesh
karnaval/o	carnival  AK
karo/o	diamonds (cards)  AK
karob/o	carrob-bean, locust (fruit)  AK
karoseri/o	
karot/o	carrot
karp/o	carp (fish)
karpen/o	yoke-elm
kart/o	card
kartav/i	trill the r strongly  AK
kartilag/o	cartilage
kartoĉ/o	cartridge (for gun)  AK
kartograf/o	
kartografi/o	
karton/o	cardboard  AK
kartuŝ/o	
karusel/o	roundabout  AK
kas/o	till, cash-box, chest (money)  AK
kased/o	
kaserol/o	stewpan, saucepan  AK
kask/o	helmet
kasked/o	(peaked) cap
kast/o	caste
kastanjet/o	castanet
kastel/o	castle
kastor/o	beaver
kastr/i	castrate  AK
kaŝ/i	hide (vb.)
kaŝtan/o	chestnut
kat/o	cat
katafalk/o	catafalque
katakomb/o	
katalepsi/o	catalepsy
katalog/o	catalogue
kataplasm/o	poultice
katapult/o	
katar/o	catarrh
katarakt/o	cataract (eye)  AK
katastrof/o	catastrophe
katedr/o	chair of state
katedral/o	
kategori/o	category
kateĥist/o	catechist
kateĥiz/i	to catechise
katekist/o	catechist
katekiz/i	to catechise
katen/o	fetter
katolik/a	catholic
katun/o	cotton, calico
kaŭci/o	
kaŭĉuk/o	india rubber
kaŭr/i	to squat
kaŭteriz/i	cauterise
kaŭz/o	cause
kav/o	cavity, hollow  AK
kavaleri/o	cavalry
kavalir/o	cavalier, knight
kavern/o	cavern
kaviar/o	caviare
kaz/o	case (gram.)  AK
kaze/o	curds  AK
kazemat/o	
kazern/o	barracks
kazin/o	
kegl/o	skittle  AK
kejl/o	peg
kel/o	cellar
kelk/a	some, a few, certain  AK
kelner/o	waiter  AK
kemi/o	chemistry
ken/o	resinous wood
kep/o	cap (milit.)
ker/o	hearts (cards)  AK
kern/o	kernel, pip  AK
kerub/o	cherub
kest/o	chest, box
kibuc/o	
kil/o	keel  AK
kilogram/o	kilogram
kilometr/o	kilometer
kimon/o	
kin/o	cinema, film (as an art form)
kinin/o	quinine
kiosk/o	
kiras/o	cuirass
kirl/i	to whirl
kirŝ/o	
kirurg/o	surgeon
kirurgi/o	surgery
kis/i	kiss
kitel/o	smock, blouse  AK
klaĉ/i	to gossip, tattle
klaft/o	fathom (measure)
klak/i	to clack
klap/o	flap
klar/a	clear
Klar/o	
klarnet/o	clarinet
klas/o	class
klasifik/i	to classify
klasik/a	classic
klav/o	key (of piano, etc.)  AK
kler/a	well-educated, cultured  AK
klient/o	client
klimat/o	climate, clime
klin/i	bend, incline
kling/o	blade
klinik/o	
klister/o	clyster
kliŝ/i	stereotype
klitor/o	
kloak/o	common sewer
klon/o	
klopod/i	endeavour
klor/o	chlorine
kloŝ/o	bell-shaped cover (clock-shade, etc.)  AK
klub/o	club, association  AK
kluk/i	to cluck
kluz/o	sluice, lock  AK
knab/o	boy
knar/i	to creak (of a wheel, door, hinge, pen)
kned/i	knead
koaks/o	coak, coke
kobalt/o	cobalt
kobold/o	gnome
koĉenil/o	cochineal
kod/o	
kodeks/o	
kodicil/o	
koeficient/o	coefficient
kofr/o	coffer
koher/a	
koincid/i	to coincide
kojn/o	wedge
kok/o	cock (bird)  AK
kokard/o	cockade
kokcinel/o	ladybird  AK
koket/a	coquet (adj.)  AK
kokluŝ/o	whooping-cough  AK
kokon/o	
kokos/o	cocoa-nut  AK
koks/o	hip, hanch  AK
kol/o	neck
kolbas/o	sausage  AK
koleg/o	colleague
kolegi/o	college
kolekt/o	collect
kolektiv/a	collective
koler/i	be angry  AK
kolibr/o	humming-bird  AK
kolik/o	colic
kolimb/o	diver (bird)  AK
kolizi/i	to collide
kolodi/o	
kolofon/o	rosin
kolomb/o	dove
kolon/o	column
kolonel/o	colonel
koloni/o	colony
kolor/o	colour, hue  AK
kolos/o	colossus
kolport/i	hawk (sell), peddle  AK
kolubr/o	adder, snake
kolumn/o	column, file (of soldiers), rib (of knitting)
kolz/o	colza
kom/o	comma
komand/i	command (mil. and nav.)  AK
komandit/o	sleeping partnership
komb/i	comb (vb.)  AK
kombin/i	combine
komedi/o	comedy
komenc/i	commence
koment/i	
komentari/o	comment
komerc/i	trade
komet/o	comet
komfort/a	comfort
komik/a	comical
komisar/o	commissary
komisi/i	commission, entrust  AK
komision/o	a commission, board
komitat/o	committee
komiz/o	clerk
komod/o	chest of drawers
kompakt/a	
kompani/o	company
kompar/i	compare
komparativ/o	comparative (gram.)
kompas/o	mariner’s compass
kompat/i	compassionate
kompens/i	compensate
kompetent/a	competent
kompil/i	compile
komplement/o	complement, object
komplet/a	complete
komplez/i	favour, kindness  AK
komplik/i	complicate
kompliment/o	compliment
komplot/o	
kompon/i	compose
kompost/i	set (type)
kompot/o	
kompren/i	understand
kompres/o	compress (bandage)  AK
kompromis/o	
kompromit/i	to compromise, to endanger
komput/i	
komun/a	common (to all)  AK
komuni/o	administer the sacrament
komunik/i	communicate
kon/i	know, recognize, be acquainted with  AK
konced/i	to concede
koncentr/i	to concentrate
koncept/o	
koncern/i	concern
koncert/o	concert
koncesi/o	license
konciz/a	
kondamn/i	condemn
kondicional/o	conditional mood (gram.)
kondiĉ/o	condition
kondolenc/i	condole (with)  AK
kondom/o	
kondor/o	
konduk/i	conduct (vb.), steer  AK
konduktor/o	conductor (of a public vehicle)
kondut/i	behave, conduct (oneself) (intr.)  AK
konekt/i	
konfederaci/o	
konfekci/o	ready-made clothes, confection (clothing)
konferenc/o	
konfes/i	confess
konfid/i	confide, trust
konfidenc/o	confidence
konfirm/i	confirm, ratify
konfisk/i	confiscate
konfit/i	preserve with sugar
konflikt/o	
konform/a	conformably
konfuz/i	confuse
konglomerat/o	
kongregaci/o	
kongres/o	congress
konjak/o	
konjekt/i	conjecture, guess  AK
konjugaci/o	conjugate
konjunkci/o	conjunction
konk/o	shell, conch  AK
konkav/a	
konker/i	to conquer
konklud/i	conclude
konkord/o	concorde
konkret/a	
konkur/i	rival, compete  AK
konkurenc/o	concurrence
konkurs/o	a competition  AK
konsci/i	be conscious of
konscienc/o	conscience
konsekr/i	to consecrate, ordain
konsekvenc/o	consequent
konsent/i	consent
konserv/i	preserve
konservativ/a	conservative
konservatori/o	
konsider/i	consider
konsil/i	advise, counsel
konsist/i	consist
konsistori/o	
konsol/i	console
konsonant/o	consonant (gram.)  AK
konspir/i	conspire
konstant/a	constant
konstat/i	prove, verify
konstern/i	dismay, disconcert, startle  AK
konstituci/o	
konstru/i	construct, build
konsul/o	
konsult/i	to consult
konsum/i	consume
kont/o	account
kontakt/o	contact
kontant/a	paid in cash
kontent/a	content
kontest/i	to contest
kontinent/o	continent
kontinu/a	continuous
kontor/o	office, counting-house
kontraband/o	
kontrabas/o	double-bass
kontrakt/i	contract
kontralt/o	contralto
kontrapunkt/o	counterpoint
kontrast/o	contrast
kontribu/i	to contribute
kontribuci/o	contribution
kontrol/i	check, verify
kontur/o	outline, contour
kontuz/i	contuse
konus/o	cone
konval/o	lily of the valley  AK
konveks/a	
konven/a	be suitable, suit  AK
konvenci/o	
konversaci/i	conversation
konvert/i	convert (vb.)  AK
konvink/i	convince
konvolvul/o	convolvulus
konvulsi/o	convulsion
kooperativ/o	
kopek/o	kopeck
kopi/o	copy
kor/o	heart
koral/o	coral
Koran/o	Coran
korb/o	basket
kord/o	string (mus. instr.)  AK
korekt/i	correct
korelativ/a	
korespond/i	correspond
koridor/o	corridor
korife/o	
kork/o	a cork  AK
korn/o	horn
korne/o	cornea
kornet/o	cornet
kornic/o	cornice  AK
kornik/o	crow
korol/o	corolla
korp/o	body
korporaci/o	corporation
korpus/o	body of an army
korsaĵ/o	bodice
korsar/o	corsair
korset/o	stays
kort/o	court, courtyard  AK
korupt/i	to bribe, to corrupt
korv/o	raven
korvet/o	sloop
kosm/o	cosmos, space
kosmetik/o	
kosmogoni/o	
kosmograf/o	
kosmografi/o	
kosmopolit/o	
kost/i	cost (vb.)  AK
Kostarik/o	
kostum/o	costume
kot/o	dirt
kotiz/i	subscribe, contribute
kotlet/o	cutlet
koton/o	cotton (product)  AK
koturn/o	quail (bird)
kov/i	brood, sit (as a hen etc.)  AK
kovert/o	envelope
kovr/i	cover
kozak/o	cossack
krab/o	crab
krabr/o	hornet
kraĉ/i	spit
krad/o	grating, crossbars  AK
krajon/o	pencil
krak/i	crack, noise  AK
kraken/o	cracknel
kramf/o	
kramp/o	clamp, bracket  AK
kran/o	tap, cock  AK
krani/o	skull
kratag/o	hawthorn
krater/o	crater
kravat/o	cravat
kre/i	create
kred/i	believe
kredit/o	credit
kreditor/o	creditor
krem/o	cream
kren/o	horse-radish
kreol/o	
kreozot/o	
krep/o	crape
krepusk/o	twilight
kres/o	
kresk/i	grow, increase
krest/o	crest (of a cock)
krestomati/o	
kret/o	chalk
krev/i	burst (intr.)  AK
kri/i	cry out, cry  AK
kribr/i	sieve, sift  AK
krim/o	crime
kriminal/a	criminal (adj.)  AK
kring/o	ring-shaped cake  AK
kripl/a	deformed, cripple (adj.)  AK
kript/o	
krisp/o	mesentery, ruffle (a)  AK
Krist/o	Christ
kristal/o	crystal
kriteri/o	
kritik/i	criticise  AK
kriz/o	crisis
krizantem/o	
kroĉ/i	hook to, cling to
krokodil/o	crocodile
kromosom/o	
kron/o	crown
kronik/a	chronicle
kronologi/o	
kronometr/o	
krop/o	crop, craw
kroz/i	cruise (of warships)  AK
kruc/o	cross
krucifiks/o	crucifix
kruĉ/o	jug, pitcher, cruise  AK
krud/a	raw, crude, rough
kruel/a	cruel
krup/o	croup
krur/o	leg  AK
krust/o	crust
krut/a	steep
ksilofon/o	
ku/o	
Kub/o	
kub/o	cube
kubut/o	elbow
kudr/i	sew
kuf/o	coif, cap, head-dress  AK
kugl/o	bullet
kuir/i	cook (vb.)  AK
kuk/o	cake, cookey  AK
kukol/o	cuckoo
kukum/o	cucumber
kukurb/o	pumpkin, gourd  AK
kul/o	gnat
kuler/o	spoon
kulis/o	slip, wing
kulp/a	guilty, at fault  AK
kult/o	worship, cult
kultur/i	culture
kumin/o	cumin
kunikl/o	rabbit
kup/o	cupping-glass
kupe/o	compartment
kupol/o	cupola, dome
kupon/o	coupon
kupr/o	copper
kur/i	run (intr.)  AK
kurac/i	treat (as an ilness), cure  AK
kuraĝ/a	courageous  AK
kurator/o	trustee, curator  AK
kurb/o	curved, bent  AK
kurent/o	current (electric)
kurier/o	courier
kurioz/a	curious, singular
kurs/o	course
kursiv/o	cursive, italics
kurten/o	curtain
kurz/o	
kusen/o	cushion
kuŝ/i	lie (down)
kutim/o	be accustomed  AK
kuv/o	tub, bath  AK
kuz/o	cousin
kvadrat/o	square
kvadratur/o	
kvadril/o	
kvaker/o	
kvalit/o	quality
kvant/o	quantity
kvaranten/o	quarantine
kvarc/o	quartz
kvart/o	quart
kvartal/o	quarter (of town), ward  AK
kvast/o	tassel
kverel/i	to wrangle, quarrel
kverk/o	oak
kvestor/o	
kviet/a	quiet, calm
kvint/o	quint
kvintesenc/o	quintessence
kvit/a	be quit of  AK
kvitanc/o	receipt (vb), give a quittance  AK
kvocient/o	
kvorum/o	
labirint/o	labyrinth
labor/i	work, labour  AK
laboratori/o	laboratory
lac/a	weary
lacert/o	lizard
laĉ/o	lace (boots, stays, etc.)  AK
lad/o	tinned iron  AK
laf/o	lava
lag/o	lake
lagun/o	
laik/o	layman
lak/o	varnish
lake/o	lackey
laks/o	diarrhoea, looseness (of bowels)  AK
lakt/o	milk (subst.)  AK
laktuk/o	lettuce
lam/a	lame
lama/o	
lamen/o	lamina
lament/i	to lament
lamp/o	lamp
lampir/o	glow-worm
lan/o	wool
lanc/o	lance
lanĉ/i	
land/o	land, country
lang/o	tongue (organ of speech)  AK
lantern/o	lantern
lanug/o	down, fluff (of feathers)  AK
lap/o	burdock
lapis/o	lunar caustic
lard/o	bacon  AK
larĝ/a	broad
larik/o	larch tree
laring/o	larynx
larm/o	tear (subst.) (shed a)  AK
larv/o	chrysalis
las/i	leave, let alone
laser/o	
last/a	last, latest
lat/o	lath
later/o	side (geom.)
latitud/o	latitude
latun/o	brass
latv/o	
laŭb/o	arbour, summer-house  AK
laŭd/i	praise
laŭr/o	laurel (tree)  AK
laŭreat/o	
laŭt/a	loud
lav/i	wash
lavang/o	avalanche
lavend/o	lavender
lazur/o	azure
lecion/o	lesson
led/o	leather
leg/i	read
legat/o	
legend/o	legend
legi/o	legion
legitim/i	to legitimize, to establish the identity
legom/o	vegetable (eatable)  AK
leĝ/o	law
lek/i	lick
lekant/o	marguerite  AK
lekci/o	lecture
leksikon/o	lexicon
lens/o	lens (optics)
lent/o	lentil
lentug/o	freckle
leon/o	lion
leontod/o	dandelion
leopard/o	leopard
lepor/o	hare
lepr/o	leprosy
lern/i	learn
lert/a	skilful
lesiv/o	lye, buck (for bleaching)  AK
letargi/o	lethargy
leter/o	letter
leŭkemi/o	
leŭtenant/o	lieutenant
lev/i	lift, raise
levkoj/o	wall-flower, gilly flower  AK
lian/o	liana (bot.)  AK
Liban/o	
libel/o	dragon fly
liber/a	free
liberal/a	
Liberi/o	
Libi/o	
libr/o	book
lice/o	high-school
licenc/o	license, permit
lien/o	spleen
lift/o	lift
lig/o	bind, tie
lign/o	wood (the substance)
liken/o	lichen (bot.)  AK
likv/o	a liquid
likvid/i	liquidate
likvor/o	liqueur (a cordial)  AK
lili/o	lily
lim/o	limit
limak/o	snail
limf/o	
limonad/o	lemonade
lin/o	flax
lingv/o	language
lini/o	line  AK
link/o	lynx
lip/o	lip
lir/o	lyre
lirik/o	lyric (poetry)
list/o	list
lit/o	bed (couch)  AK
litani/o	litany
liter/o	letter (of alphabet)  AK
literatur/o	literature
litograf/i	to lithograph
litografi/o	lithography
litr/o	
liturgi/o	liturgy
liut/o	lute
liver/i	deliver, furnish
livre/o	livery
lob/o	lobe
lod/o	half an ounce
log/i	entice
logaritm/o	
logik/o	logic
logogrif/o	
loĝ/i	dwell, lodge, live  AK
loĝi/o	lodge, box (theatre)  AK
lojal/a	loyal
lojt/o	eel-pout, lote
lok/o	place
lokomobil/o	portable engine
lokomotiv/o	locomotive
lol/o	tare (plant)  AK
London/o	
long/a	long
longitud/o	longitude
lonicer/o	honey-suckle
lord/o	Lord (British)
lorn/o	perspective-glass
lot/o	cast lots
loteri/o	lottery
lotus/o	lotus
lozanĝ/o	lozenge (heraldry)
lu/i	hire, take on rent  AK
lubrik/i	to lubricate
lucern/o	lamp (in church)
lud/i	play
Ludovik/o	
luk/o	1/a) dormer-window, b) trap-door, c) air-hole, ventilator; 2/a) hatchway, b) port-hole; 3/ man-hole
luks/o	luxury  AK
lukt/i	to wrestle
lul/i	lull asleep, rock
lum/i	shine, give light  AK
lumb/o	loins, haunch
lumbrik/o	earth-worm
lun/o	moon
lunatik/o	lunatic
lund/o	Monday
lup/o	wolf
lupol/o	hops
lustr/o	lustre, chandelier
lut/i	solder
Luter/o	
lutr/o	common otter
mac/o	unleavened bread
maĉ/i	chew
madon/o	Madonna
magazen/o	shop, store, warehouse  AK
magi/o	magic, black art
magnet/o	magnet
magnetism/o	magnetism
magnetofon/o	
mahagon/o	mahogany
maiz/o	maize
Maj/o	May
majest/a	majestic, dignified  AK
majolik/o	
majonez/o	
major/o	
majstr/o	master (of his art)  AK
majuskl/o	
makadam/o	
makaron/o	macaroon
makaroni/o	macaroni
makler/i	act as broker, deal  AK
maksim/o	maxim
maksimum/o	maximum
makul/o	stain
makzel/o	jaw-bone, cheek-bone
malakit/o	
malari/o	
maleol/o	ankle
malic/a	malicious
malt/o	malt
malv/o	mallow
mam/o	breast, udder  AK
mamut/o	
man/o	hand
mana/o	manna
mandaren/o	
mandarin/o	
mandat/o	mandate
mandolin/o	mandoline
mang/o	
mangan/o	manganese
manĝ/i	eat
mani/o	mania
manier/o	manner
manifest/i	manifesto
manifestaci/o	manifestation
manik/o	sleeve
maniok/o	
manipul/i	
mank/i	want, lack  AK
manometr/o	
manovr/i	manoeuvre (milit. and nav.)  AK
mansard/o	
mantel/o	mantle
manufaktur/o	
manuskript/o	manuscript
map/o	map
mar/o	sea
marasm/o	
marcipan/o	marzipan (almond paste)  AK
marĉ/o	swamp, marsh
marĉand/i	bargain (vb.)  AK
mard/o	Tuesday
margarin/o	margarine
marĝen/o	margin
Mari/o	
marin/i	to marinade, pickle
marionet/o	puppet
mark/o	mark
markiz/o	marquis
markot/o	layer (hort.)  AK
marmelad/o	marmalade
marmor/o	marble
marmot/o	marmot
Marok/o	
maroken/o	morocco leather  AK
marŝ/i	march, walk
marŝal/o	marshal
Mart/o	March
martel/o	hammer
martir/o	martyr
mas/o	mass
masaĝ/o	massage
masiv/a	massive
mask/o	mask
mason/i	build with stone
mast/o	mast
mastik/o	mastic, putty  AK
mastr/o	master (of house), host  AK
maŝ/o	mesh
maŝin/o	machine
mat/o	mat
matador/o	
mate/o	
matematik/o	mathematics
maten/o	morning
materi/o	matter (substance)
material/o	material
matrac/o	mattress
matric/o	
matur/a	mature, ripe  AK
maŭzole/o	
mazurk/o	mazurka
mebl/o	furniture
meĉ/o	wick
medal/o	medal
medalion/o	medallion
medi/o	sphere of life, circle, medium
medicin/o	medicine
medikament/o	
medit/i	reflect, meditate
Mediterane/o	Mediterranean
medium/o	
medol/o	marrow, medulla (anat., bot.)
meduz/o	medusa
meĥanik/o	mechanics
meĥanism/o	mechanism
mejl/o	mile
mekanik/o	mechanics
mekanism/o	mechanism
Meksik/o	
mel/o	badger
melankoli/o	melancholy
melas/o	molasses
meleagr/o	turkey
melis/o	balm mint
melk/i	milk (vb.)
melodi/o	melody
melodram/o	melodrama
melon/o	melon
melongen/o	
membr/o	member, limb  AK
membran/o	membrane
memor/i	remember  AK
menci/i	to mention
mend/i	bespeak, give an order  AK
mens/o	intellect, mind
mensog/i	tell a lie
menstru/i	
ment/o	mint
menton/o	chin
mentor/o	
menu/o	menu
meridian/o	
merit/i	merit
meriz/o	bird-cherry
merkat/o	market
merkred/o	Wednesday
merl/o	blackbird
merlang/o	whiting
mes/o	mass
mesaĝ/o	
mesi/o	Messiah
mespil/o	medlar
met/i	put, place
metafizik/o	metaphysics
metafor/o	metaphor
metal/o	metal
metalurgi/o	metallurgy
metamorfoz/o	metamorphosis
metempsikoz/o	
meteor/o	
meteorolog/o	
meteorologi/o	
meti/o	handicraft
metod/o	method
metr/o	meter
metrik/o	
metronom/o	
metropol/o	
mev/o	sea-gull
mez/o	middle
mezur/i	measure
miasm/o	miasma
miaŭ/i	mew
miel/o	honey
mien/o	mien, air
migdal/o	almond
migr/i	migrate
Miĥael/o	
mikrob/o	
mikrofon/o	
mikrometr/o	
mikroskop/o	
miks/i	mix
mild/a	gentle, mild
mili/o	millet
miliard/o	thousand millions
miligram/o	
milimetr/o	
milion/o	
milit/i	make war  AK
milv/o	kite
mimik/o	mimicry
mimoz/o	
min/o	mine
minac/i	menace, threaten  AK
minaret/o	minaret
mineral/o	mineral
mineralog/o	
mineralogi/o	
miniatur/o	miniature
minimum/o	minimum
ministeri/o	ministry (pol.)
ministr/o	minister (of state)
minuskl/o	
minut/o	minute
miogal/o	musk-rat
miop/a	short-sighted  AK
miozot/o	forget-me-not
mir/i	wonder
mirabel/o	
miraĝ/o	
mirakl/o	miracle
mirh/o	myrrh
miriad/o	myriad
miriametr/o	
mirt/o	myrtle
mirtel/o	bilberry
misi/o	mission
mister/o	mystery
mistifik/i	to hoax, to fool
mistik/o	
mit/o	myth
mitolog/o	
mitologi/o	mythology
mitr/o	mitre
mitul/o	mussel
mizer/o	distress, misery
mobiliz/i	mobilise
mod/o	fashion, mood (gram.)  AK
model/o	model
modem/o	
moder/a	moderate
modern/a	modern
modest/a	modest
modif/i	to modify
modul/i	modulate
mok/i	mock, ridicule  AK
mol/a	soft
molekul/o	molecule
molusk/oj	mollusc
moment/o	moment
mon/o	money
monaĥ/o	monk, friar
monarĥ/o	monarch
monarĥi/o	monarchy
monark/o	monarch
monarki/o	monarchy
monat/o	month
mond/o	world
moned/o	jack-daw, chough
monogram/o	
monolog/o	monologue
monomani/o	
monopol/o	monopoly
monoteism/o	
monoton/a	monotonous
monstr/o	monster
mont/o	mountain
montr/i	show (vb.)  AK
monument/o	monument
mops/o	pug-dog
mor/o	custom, usage  AK
moral/o	moral
morbil/o	measles
mord/i	bite
morfin/o	morphia
mort/i	die
morter/o	mortar
moru/o	codfish
morus/o	mulberry
mosk/o	musk
moske/o	mosque
moskit/o	mosquito
most/o	must
moŝt/o	universal title; e. g. vi/a reĝ/a moŝt/o your majesty; vi/a moŝt/o your honor
motiv/o	motive
motor/o	motor
mov/i	move
mozaik/o	
muel/i	grind, mill  AK
muf/o	muff
muĝ/i	roar (wind, etc.)  AK
muk/o	mucus  AK
mul/o	mule
muld/i	
mult/a	much, many
multiplik/i	to multiply
mumi/o	mummy
munici/o	ammunition
munt/i	to mount, fit up (machinery, apparatus), set (jewellery)
mur/o	wall
murd/i	to murder, kill unlawfully
murmur/i	murmur
mus/o	mouse
musk/o	moss
muskat/o	nutmeg
muskol/o	muscle
muslin/o	muslin
mustard/o	mustard
mustel/o	weasel, marten  AK
muŝ/o	fly (a)
mut/a	dumb
muz/o	muse
muze/o	museum
muzel/o	muzzle, snout (of animals, fish)
muzik/o	music
naci/o	nation
nadl/o	needle
naft/o	naphtha
naftalin/o	
naĝ/i	swim
naiv/a	artless
najbar/o	neighbour
najl/o	nail
najtingal/o	nightingale
nan/o	
nanken/o	nankeen, nankin
nap/o	cabbage-turnip  AK
narcis/o	daffodil
narkot/i	to narcotize
narkotik/o	narcotic
nas/o	hoop-net
nask/i	bear, produce
natri/o	natrium, sodium
natur/o	nature
naturalism/o	naturalism
naŭz/i	nauseate
nav/o	nave
navigaci/o	navigation
naz/o	nose
nebul/o	fog
neces/a	necessary
Nederland/o	
negativ/a	
neglekt/i	to neglect
negliĝ/o	neglige, loose-gown  AK
negoc/o	business
negr/o	negro
neĝ/o	snow
nekrolog/o	necrology, an obituary notice
nektar/o	nectar
neologism/o	
nep/o	grandson
nepotism/o	
nepr/a	without fail  AK
nerv/o	nerve
nervoz/a	nervous, fidgety, excitable, highly-strung
nest/o	nest
net/o	clean (as a copy), neat  AK
neŭtr/a	
neŭtral/a	
nev/o	nephew
niĉ/o	niche
nigr/a	black
nihilism/o	
nihilist/o	
Nikaragv/o	
nikel/o	nickel
Nikodem/o	
Nikola/o	
nikotin/o	
nilon/o	nylon
nimb/o	
nimf/o	nymph
nivel/o	level (sea, etc.)  AK
niz/o	sparrow-hawk
nobel/o	nobleman
nobl/a	noble
nod/o	knot
nokt/o	night
noktu/o	screech-owl
nom/o	name
nomad/o	
nombr/o	number
nominal/a	nominal
nominativ/o	nominative
nord/o	north
norm/o	
normal/a	normal
norveg/o	
nostalgi/o	nostalgia
not/o	make a note of, note  AK
notari/o	notary
nov/a	new
novel/o	short story
Novembr/o	November
novic/o	novice
nuanc/o	nuance, shade, hue  AK
nub/o	cloud
nud/a	nude, naked, bare  AK
nuk/o	nape (of neck)  AK
nuks/o	nut
nul/o	zero, nought  AK
numer/o	number (of a magazine, etc.)
numismatik/o	
nunci/o	nuncio
nutr/i	nourish, feed (trans.)  AK
oaz/o	oasis
obe/i	obey
obelisk/o	
objekt/o	object
objektiv/a	
oblat/o	wafer, seal  AK
obligaci/o	
oblikv/a	oblique
obol/o	
observ/i	observe
observatori/o	observatory
obstakl/o	obstacle, hindrance
obstin/a	obstinate
obstrukc/o	obstruction
obtuz/a	obtuse, dull, muffled
ocean/o	ocean
od/o	ode
odor/i	give out odour, smell  AK
ofend/i	offend
ofer/i	sacrifice, offer  AK
ofert/i	to offer, to tender (for sale or supply)
ofic/o	office, duty, function  AK
oficial/a	official
oficir/o	officer (mil. and nav., etc.)  AK
oft/a	often
ogiv/o	ogive
okaz/i	happen
okcident/o	west
oksid/o	oxide
oksigen/o	oxygen
oksikok/o	cranberry  AK
oktav/o	
Oktobr/o	October
okul/o	eye
okult/a	
okup/i	occupy
okzal/o	sorrel (plant)  AK
ole/o	oil
oleandr/o	oleander
oligarĥ/o	
oligarĥi/o	oligarchy
oligark/o	
oligarki/o	oligarchy
oliv/o	olive
omaĝ/o	
omar/o	lobster
ombr/o	shadow
ombrel/o	umbrella
omnibus/o	omnibus
ond/o	wave
oniks/o	
onkl/o	uncle
onobrik/o	esparcet
opal/o	opal
oper/o	opera
operaci/i	operation
opi/o	opium
opini/i	be of opinion, think  AK
opon/i	to oppose
oportun/a	opportune, suitable
opozici/i	
optativ/o	
optik/o	optics
optimism/o	
optimist/o	optimist
or/o	gold
orakol/o	oracle
oranĝ/o	orange
orator/o	orator
orbit/o	orbit (anat., astr.)
ord/o	order, arrange
orden/o	order (of knighthood etc.)  AK
ordinar/a	ordinary
ordon/i	order, command
orel/o	ear
orf/o	orphan
organ/o	organ
organik/a	
organism/o	organism
organiz/i	organize
orgasm/o	
orgen/o	organ (mus.)  AK
orgi/o	
orient/o	east, orient  AK
origin/o	origin
original/o	original
oriol/o	golden thrush
orkestr/o	orchestra
orkide/o	
ornam/i	ornament (vb.), adorn  AK
ornitolog/o	
ornitologi/o	ornithology
orografi/o	
ort/o	right angle
ortodoks/a	
ortografi/o	orthography
osced/i	yawn, gape  AK
ost/o	bone
ostr/o	oyster
ostracism/o	
ov/o	egg
ovaci/o	ovation
oval/o	oval
ozon/o	
pac/o	peace
pacienc/a	patience
pacient/o	patient
Pacifik/o	The Pacific
pacifism/o	pacifism
pacifist/o	pacifist
paĉul/o	patchouli
paf/i	shoot
pag/i	pay
pagod/o	
paĝ/o	page (book)  AK
paĝi/o	page (servant)  AK
pajl/o	straw
pak/o	pack, put up  AK
Pakistan/o	
pal/a	pale
palac/o	palace
palanken/o	
palat/o	palate
paleograf/o	
paleografi/o	
paleontolog/o	
paleontologi/o	
paletr/o	palette
palinur/o	rock lobster
palis/o	pale, stake
palisandr/o	rosewood
palm/o	palm-tree  AK
palp/i	touch, feel
palpebr/o	eyelid
palt/o	overcoat
pamflet/o	satirical pamphlet
pan/o	bread
Panam/o	
pane/o	breakdown, failure
panel/o	panel
panik/o	
pankreat/o	
panoram/o	
pantalon/o	trousers  AK
panteism/o	
panteist/o	
panter/o	panther
pantofl/o	slipper  AK
pantomim/o	pantomime
pap/o	pope
papag/o	parrot
papav/o	poppy
paper/o	paper
papili/o	butterfly
papirus/o	
paprik/o	
par/o	pair
parabol/o	
parad/i	parade, make a show  AK
paradigm/o	
paradiz/o	paradise
paradoks/o	
paraf/o	
parafin/o	paraffine
parafraz/o	
paragraf/o	paragraph
Paragvaj/o	
paralel/o	parallel
paralelogram/o	
paraliz/i	paralyse
paraŝut/o	parachute
parazit/o	parasite
pardon/i	forgive
parenc/o	relation
parentez/o	parenthesis
parfum/o	perfume, scent  AK
parget/o	parquetry  AK
Pariz/o	
park/o	park
parker/e	by heart  AK
parlament/o	parliament
parodi/o	parody
paroĥ/o	parish
paroksism/o	paroxysm
parol/i	speak
part/o	part
parter/o	pit (theatre), ground-floor  AK
parti/o	party, faction  AK
particip/o	participle
partitur/o	partition, score
paru/o	tomtit, titmouse  AK
pas/i	pass (intr.)  AK
pasaĝer/o	passenger
pasament/o	braid-trimmings, passementerie  AK
paser/o	sparrow
pasi/o	passion (not anger)  AK
pasiv/a	passive
Pask/o	Easter
paskvil/o	pasquinade
pasport/o	passport  AK
past/o	dough, paste  AK
pasteĉ/o	tart, pie, pasty  AK
pastel/o	lozenge  AK
pastinak/o	parsnip
pastr/o	priest, pastor
paŝ/i	step, pace  AK
paŝt/i	feed (animals), graze, pasture (trans.)  AK
paŝtel/o	pastel, coloured crayon
pat/o	frying-pan
patent/o	patent
patolog/o	
patologi/o	
patos/o	pathos, passion
patr/o	father
patrici/o	patrician
patriot/o	patriot
patriotism/o	patriotism
patrol/o	patrol
patron/o	patron
Paŭl/o	
paŭz/i	pause
pav/o	peacock  AK
pavian/o	baboon
pavilon/o	
pavim/o	pavement
pec/o	piece
peĉ/o	pitch
pedagog/o	pedagogue
pedagogi/o	pedagogy, education of children
pedal/o	pedal
pedant/a	pedant
pedel/o	beadle
pedik/o	louse
peg/o	woodpecker  AK
pejzaĝ/o	landscape
pek/i	sin
pekl/i	pickle in brine, salt (vb.)  AK
pel/i	drive, chase (vb.)  AK
pelerin/o	tippet, pelerine
pelikan/o	pelican
pelt/o	fur
pelv/o	basin, pelvis
pen/i	endeavour, try to  AK
penc/o	penny
pend/i	hang (intr.)  AK
pendol/o	pendulum  AK
penetr/i	penetrate
penicilin/o	
penik/o	paintbrush
penis/o	
pens/i	think
pensi/o	pension
pension/o	boarding-house
pent/i	repent
pentametr/o	
pentekost/o	Pentecost, Whitsuntide
pentr/i	paint (vb.)  AK
peoni/o	peony
pep/i	chirp, warble  AK
pepsin/o	pepsine
percept/o	perception
perĉ/o	pope, ruffe (fish) (acerina vulg.)  AK
perd/i	lose
perdrik/o	partridge
pere/i	perish
perfekt/a	perfect
perfid/i	betray
pergamen/o	parchment
perimetr/o	
period/o	period
periskop/o	
peristil/o	
peritone/o	peritoneum
perk/o	perch (fish)  AK
perl/o	pearl
perlamot/o	mother of pearl
permes/i	permit, allow
peron/o	door-stop, platform (in a station, etc.)  AK
persekut/i	persecute, prosecute  AK
persik/o	peach
persist/i	persist
person/o	person
perspektiv/o	perspective
persvad/i	
Peru/o	
peruk/o	wig
pes/i	weigh (vb. act.)
pesimism/o	
pesimist/o	
pest/o	plague
pet/i	request, beg
petal/o	
petard/o	
petol/i	be mischievous, romp, wanton  AK
Petr/o	
petrol/o	petroleum  AK
petromiz/o	lamprey
petrosel/o	parsley
pez/a	weigh (vb. neut.)
pfenig/o	pfennig
pi/a	pious
pian/o	piano
piastr/o	
pic/o	
pice/o	silver fir-tree  AK
pied/o	foot (body)  AK
piedestal/o	pedestal
pig/o	magpie
pigme/o	pygmy
piĵam/o	
pik/i	prick, sting; spade (cards)  AK
piked/o	picket (milit.), piquet (cards)  AK
piknik/o	
pil/o	(electric) pile
pilastr/o	
pilgrim/i	go on a pilgrimage
pilk/o	ball (to play with)
pilol/o	pill
pilot/o	pilot, loadsmann
pin/o	pine-tree
pinĉ/i	pinch
pingl/o	pin
pingven/o	
pini/o	Siberian cedar  AK
pint/o	point, tip, peak
pioĉ/o	pickaxe, mattock
pionir/o	pioneer
pip/o	pipe (tobacco)
pipr/o	pepper
pips/o	pip (poultry disease)  AK
pir/o	pear
piramid/o	pyramid
pirat/o	pirate
pirit/o	gravel, pyrites
pirol/o	bullfinch
piroz/o	pirosis (med)  AK
pis/i	
pist/i	pound, bray (in a mortar)  AK
pistak/o	pistachio-nut
pistil/o	
pistol/o	pistol
piŝt/o	piston, sucker
pivot/o	pivot
piz/o	pea
plac/o	public square
plaĉ/i	be pleasing, please (intr.)  AK
plad/o	dish, platter  AK
plafon/o	ceiling
plag/o	plague, calamity
plagiat/o	plagiarism
plan/o	plan
pland/o	sole (of the foot)
planed/o	planet
plank/o	floor
planto, plant/	plant (vb.)
plantag/o	plantain (bot.)
plast/o	plastic (material)
plastik/o	plastic art
plastr/o	plaster (med.)  AK
plat/a	flat, plain
platan/o	plane-tree
platen/o	platina
plaŭd/i	splash, clap
pleb/o	the plebeians, common people, lower orders
pled/i	
plekt/i	weave, plait
plen/a	full, complete  AK
plend/i	complain
pleonasm/o	
plet/o	tray, salver  AK
pleŭronekt/o	brill
plezur/o	pleasure
plik/o	Polish ringworm  AK
plonĝ/i	to dive, to plunge
plor/i	mourn, weep
plot/o	roach (fish.)  AK
plug/i	plough (vb.)  AK
plum/o	feather, pen  AK
plumb/o	lead (metall)
plur/aj	several
plural/o	plural (gram.)
pluŝ/o	plush
plutokrat/o	
plutokrati/o	plutocracy
pluv/o	rain
pneŭmatik/o	pneumatics
podagr/o	gout
podi/o	podium, stage
poem/o	poem
poent/o	point (in games)  AK
poet/o	poet
poezi/o	poetry
pokal/o	cup, goblet
pol/o	
polemik/o	polemics
polen/o	
polic/o	police (the system)  AK
poliglot/o	
poligon/o	buckwheat
Polinezi/o	
polip/o	
polis/o	
politeism/o	
politik/o	politics
polk/o	polka
polp/o	
polur/o	polish, gloss  AK
polus/o	pole (geol.)  AK
polv/o	dust (subst.)  AK
pom/o	apple
pomad/o	pomatum
pomp/o	
ponard/o	dagger, poniard
pont/o	bridge
ponton/o	
popl/o	poplar
popol/o	people
popular/a	
por/o	pore
porcelan/o	china, porcelain  AK
porci/o	portion
pord/o	door
pore/o	leek
porfir/o	porphyry
pork/o	pig  AK
port/i	carry  AK
portal/o	
porter/o	porter, beer  AK
portik/o	
portret/o	portrait
posed/i	possess
posten/o	post (milit.)  AK
postul/i	require, claim
poŝ/o	pocket
poŝt/o	post (the system)  AK
pot/o	pot
potas/o	potash
potenc/o	might, power
pov/i	be able, can
poz/i	pose
pozici/o	position
pozitiv/a	positive
praktik/o	practice (of a profession)  AK
pram/o	ferry-boat, praam  AK
prav/a	right (to be in the right)
precip/a	particularly
preciz/a	precise
predik/i	preach
predikat/o	predicate (gram.)  AK
prefekt/o	prefect
prefer/i	prefer
prefiks/o	prefix
preĝ/i	pray
prelat/o	prelate
preleg/i	to lecture
prelud/o	prelude
prem/i	press
premi/o	prize, reward (subst.)  AK
premis/o	
pren/i	take
prepar/i	prepare
prepozici/o	preposition
prerogativ/o	
pres/i	print (vb.)
preskrib/i	to prescribe
prestiĝ/o	
pret/a	ready
pretekst/o	pretext
pretend/i	lay claim to  AK
preterit/o	
prez/o	price
prezent/i	present (vb.), introduce (a person)  AK
prezid/i	preside
primitiv/a	
primol/o	primrose
princ/o	prince
princip/o	principle
printemp/o	springtime  AK
prior/o	
prism/o	prism
privat/a	private
privilegi/o	privilege
probabl/a	probable
problem/o	problem
proced/i	to proceed
procedur/o	
proces/o	lawsuit, process
procesi/o	procession
produkt/o	produce
profan/i	profane
profesi/o	profession
profesor/o	professor
profet/o	prophet
profil/o	profile
profit/o	profit, gain
profund/a	deep
prognoz/o	prognosis
program/o	programme
progres/i	advance, progress
projekci/o	projection
projekt/o	project
proklam/i	proclaim
prokrast/i	delay, defer  AK
proksim/a	near
prolet/o	proletarian
proletari/o	proletarian
prolog/o	prologue
promen/i	to walk, promenade  AK
promes/i	promise
promontor/o	promontory, cape
pronom/o	pronoun
prononc/i	to pronounce
propagand/i	propaganda
propon/i	propose, suggest
proporci/o	proportion
propozici/o	sentence
propr/a	own (one’s own)
prospekt/o	prospectus
prosper/i	to succeed in  AK
prostat/o	
prostitu/i	
protagonist/o	
protein/o	
protekt/i	protect, patronise
protektorat/o	
protest/i	protest
protokol/o	minutes of proceedings
prototip/o	
prov/i	attempt, try to  AK
proverb/o	proverb
Providenc/o	Providence
provinc/o	province
proviz/o	provide
provizor/a	provisional
provok/i	to provoke, defy, challenge
proz/o	prose
prozelit/o	
prozodi/o	prosody
prudent/a	reasonable  AK
prujn/o	rime, hoar frost
prun/o	plum
prunel/o	sloe
prunt/o	borrow, loan  AK
pruv/i	prove, demonstrate
psalm/o	psalm
pseŭdonim/o	
psikolog/o	
psikologi/o	
pub/o	
publik/o	public
pudel/o	spaniel
puding/o	pudding
pudr/o	powder (cosmetic)  AK
puf/o	stuffing, puff
pugn/o	fist
pul/o	flea
pulĉinel/o	punchinello
pulm/o	lung
pulp/o	
puls/o	pulse
pulv/o	gunpowder
pulvor/o	powder (med. or chem.)  AK
pumik/o	pumice-stone
pump/i	pump (vb.)  AK
pun/i	punish
punc/a	crimson red
punĉ/o	punch (drink)  AK
pund/o	
punkt/o	full stop, dot, point  AK
punt/o	lace (point, etc.)  AK
pup/o	doll
pupil/o	pupil (eye)  AK
pupitr/o	reading-desk
pur/a	clean, pure  AK
purgatori/o	purgatory
puritan/o	
purpur/o	purple
pus/o	pus, matter
pustul/o	pustule
puŝ/i	push
put/o	well (subst.)
putor/o	pole-cat, skunk  AK
putr/i	rot, putrify  AK
rab/i	rob
rabarb/o	rhubarb
rabat/o	rebate, discount
raben/o	Jewish rabbi
rabi/o	rabid, rabies
rabot/i	plane (vb.)  AK
raci/o	rational
racionalism/o	
racionalist/o	
rad/o	wheel
radar/o	
radi/o	beam, ray
radiator/o	radiator
radik/o	root
radikal/a	radical
radiograf/i	
rafan/o	radish
rafin/i	refine
raj/o	ray (fish)
rajd/i	ride
rajt/o	right, authority
raked/o	
raket/o	rocket
rakont/i	tell, relate
ramp/i	crawl
ran/o	frog
ranc/a	rancid
rand/o	edge, border, hem (s.)  AK
rang/o	rank, dignity
ranunkol/o	ranunculus
rap/o	turnip
rapid/a	quick, rapid
rapir/o	rapier, foil  AK
raport/i	report
ras/o	breed
rasp/i	rasp, grate (vb.)  AK
rast/i	rake (vb.)  AK
rat/o	rat
raŭk/a	hoarse
raŭp/o	caterpillar
rav/i	enrapture, delight  AK
raz/i	shave
reakci/o	reaction
real/a	real
realism/o	realism
rebus/o	rebus
recenz/i	to criticize, to write a review of
recept/o	recipe, prescription
reciprok/a	mutual, reciprocal
recitativ/o	
redakci/o	editorial department  AK
redakt/i	edit, draw up
redaktor/o	compiler, editor
redukt/i	to reduce (math., chem.)
ref/o	reef (in a sail)
referenc/o	reference
reflekt/i	to reflect (phys.)
reformaci/o	reformation
refut/i	refute
reg/i	rule, govern  AK
regal/i	entertain, regale
regent/o	a regent
regiment/o	regiment
region/o	district, region, part  AK
registr/o	register
regn/o	State (the)  AK
regol/o	wren
regul/o	rule (subst.)  AK
reĝ/o	king
reĝim/o	regime
reĝisor/o	
reklam/i	advertisement
rekomend/i	recommend
rekompenc/o	reward
rekord/o	
rekrement/o	recrement, husks, draff
rekrut/o	recruit
rekt/a	straight
rektor/o	
rel/o	a rail  AK
relativ/a	
relief/o	relief
religi/o	religion
rem/i	row (vb.)
rembur/i	quilt (vb.), stuff, pad  AK
rempar/o	rampart
ren/o	kidney
rendevu/o	appointment
renesanc/o	
renkont/i	meet
rent/o	yearly income  AK
renvers/i	upset
repertuar/o	repertory
reputaci/o	reputation
respekt/i	respect
respektiv/a	
respond/i	reply
respublik/o	republic
resto, rest/i	remain
restoraci/o	eating-house
ret/o	net (a)  AK
retin/o	retina
retor/o	
retorik/o	rhetoric
retort/o	retort (chem.)
reŭmatism/o	
rev/i	dream (vb.)  AK
revelaci/o	revelation
revizi/i	to revise
revizor/o	government inspector, inspector-general
revoluci/i	revolution
revolver/o	revolver
revu/o	
rezed/o	mignonette
rezerv/o	reserve
rezign/i	to resign
rezignaci/o	resignation
rezin/o	resin
rezist/i	to resist
rezoluci/o	
rezon/i	to reason
rezult/i	
rezultat/o	result
rib/o	currant
ribel/i	revolt, rebel (vb.)  AK
ricev/i	obtain, get, receive
ricin/o	castor-oil (plant)
riĉ/a	rich
rid/i	laugh
rif/o	reef  AK
rifuĝ/i	take refuge, shelter  AK
rifuz/i	refuse
rigard/i	behold, look at
rigid/a	stiff, rigid
rigl/i	bolt (vb.)  AK
rigor/a	rigorous
rikan/i	to grin
rikolt/i	reap
rilat/i	relate to  AK
rim/o	rhyme
rimark/i	remark
rimed/o	means, remedy
rimen/o	strap (a)  AK
ring/o	ring (subst.)
rinocer/o	rhinoceros
rip/o	rib
ripar/i	repair
ripet/i	repeat
ripoz/i	repose
riproĉ/i	reproach
risk/i	risk
rism/o	ream
risort/o	spring (s.) (mech.)  AK
rit/o	rite
ritm/o	rhythm
rivel/i	to reveal, to develop (phot.)
river/o	river
riverenc/i	curtsey  AK
rivolu/o	revolution (around an axis)
riz/o	rice
rob/o	robe, gown
robot/o	
rod/o	landing-place (mar.)  AK
rojalist/o	royalist
rok/o	rock
rokok/o	
rol/o	part (in a play)
roman/o	romance
romanc/o	
romantik/o	
romb/o	rhomb
romp/i	break
rond/o	round, circle
ronĝ/i	
ronk/i	snore
ros/o	dew
rosmar/o	walrus  AK
rosmaren/o	rosemary
rost/i	roast
rostr/o	trunk (proboscis)  AK
rot/o	troop, company (soldiers)  AK
rotaci/i	
rotond/o	
roz/o	rose
rozari/o	rosary
rub/o	rubbish
ruband/o	ribbon
ruben/o	ruby
rubl/o	rouble
rubrik/o	rubric
rubus/o	blackberry
ruĝ/a	red
ruin/o	ruins, a ruin  AK
rukt/i	eructation  AK
rulo, rul/i	roll
rulet/o	
rum/o	rum
ruman/o	
rus/o	
rust/o	rust
rut/o	rue
rutin/o	routine
ruz/a	cunning, sly  AK
sabat/o	Saturday
sabl/o	sand
sabr/o	sabre
sacerdot/o	Roman Catholic priest
safir/o	saphire
safran/o	saffron
sag/o	arrow
sagac/a	subtle, crafty, sharp
sagu/o	
saĝ/a	wise
sak/o	sack
sakr/o	sacrum (anat.)  AK
sakrament/o	sacrament
sakristi/o	
saksofon/o	
sal/o	salt
salajr/o	wages, salary
salamandr/o	salamander
salat/o	salad  AK
sald/o	balance of account
salik/o	willow
salikok/o	
saliv/o	spittle
salm/o	salmon
salon/o	drawing-room  AK
salpetr/o	saltpetre
salt/i	leap, jump
salut/i	salute, greet
salv/o	
salvi/o	sage
sam/a	same
sambuk/o	elder-tree  AK
samovar/o	
san/a	healthy
sandal/o	sandal
sandviĉ/o	sandwich
sang/o	blood
sankci/o	sanction
sankt/a	sacred, holy  AK
santal/o	sandal-wood
sap/o	soap
sardel/o	sardine  AK
sark/i	weed (vb.)  AK
sarkasm/o	sarcasm
sarkofag/o	
sat/a	satiated
satan/o	satan
satelit/o	
saten/o	satin
satir/o	satire
satrap/o	satrap
satur/i	saturate  AK
saŭc/o	sauce
sav/i	save, rescue  AK
scen/o	scene
sceptr/o	sceptre
sci/i	know
scienc/o	science
sciur/o	squirrel
seb/o	tallow, suet  AK
seg/i	saw (vb.)  AK
segment/o	
seĝ/o	chair  AK
sek/a	dry
sekal/o	rye
sekc/i	dissect
sekci/o	section
sekreci/o	secretion
sekret/o	secret
sekretari/o	secretary
seks/o	sex
sekt/o	
sektor/o	
sekund/o	second (a)  AK
sekundant/o	second (in a duel)
sekur/a	safe, secure
sekv/i	follow
sel/o	saddle
selakt/o	whey
sem/o	sow
semafor/o	
semajn/o	week
seminari/o	seminary
senat/o	senate
senc/o	sense, meaning  AK
send/i	send
sens/o	sense (the five senses)
sensaci/o	
sent/i	feel, perceive
sentenc/o	sentence, judgment  AK
sentimental/a	
sepi/o	cuttle-fish
Septembr/o	September
septet/o	septet
seraf/o	
serajl/o	
serĉ/i	search
seren/a	serene
serenad/o	
serĝent/o	sergeant
seri/o	series
serioz/a	serious
serpent/o	serpent
serur/o	lock (fastening)  AK
serv/i	serve
servic/o	set of dishes, plates, etc.
servut/o	bondage  AK
sesi/o	
sever/a	severe, strict  AK
sevrug/o	sturgeon
sezon/o	season
sfer/o	sphere
sfinks/o	
sfinkter/o	sphincter
sibl/i	hiss, whizz
sid/i	sit
sieĝ/i	besiege
sifilis/o	
sifon/o	
sigel/o	seal (vb.)
sign/o	sign, token
signal/o	signal
signif/i	signify, mean
silab/o	syllable
silent/i	be silent  AK
silici/o	
silik/o	flint
silk/o	silk
silogism/o	
siluet/o	
silur/o	shad-fish
silvi/o	warbler (bird)  AK
simbol/o	symbol
simetri/o	symmetry
simfoni/o	symphony
simi/o	monkey
simil/a	like, similar
simpati/o	sympathy
simpl/a	simple
simptom/o	
sin/o	bosom, breast, lap
sinagog/o	
sinap/o	mustard-plant
sincer/a	sincere
sindikat/o	sindicate
sinedri/o	sanhedrim
singular/o	the singular
singult/i	hiccough
sinjor/o	Sir, Mr
sinkop/o	syncope
sinod/o	synod
sinonim/o	synonym
sinoptik/a	
sintaks/o	syntax
sintez/o	
siren/o	siren
Siri/o	
siring/o	lilac
sirop/o	syrup
sistem/o	system
sitel/o	bucket, pail  AK
situ/o	site, situation, position
situaci/o	situation, position  AK
skabi/o	mange, scab  AK
skadr/o	squadron
skal/o	scale (measure)  AK
skalp/o	
skan/i	
skandal/o	
skapol/o	shoulder-blade  AK
skarab/o	beetle
skarlat/o	scarlet
skarlatin/o	scarlet fever
skarp/o	scarf
skatol/o	small box, case
skeĉ/o	
skelet/o	skeleton
skem/o	scheme
skeptik/a	sceptic
skerc/o	scherzo
skerm/i	fence (vb.)  AK
ski/o	ski
skism/o	schism
skiz/o	sketch
sklav/o	slave
skol/o	school (of thought, opinion, art, etc.) (noto)
skolastik/o	
skolop/o	woodcock  AK
skolt/o	
skorbut/o	scurvy
skorpi/o	scorpion
skorzoner/o	black salsify
skrap/i	shave, scrape
skrib/i	write
skrofol/o	scrofula
skrupul/o	
sku/i	shake (trans.)  AK
skulpt/i	sculpture
skurĝ/o	scourge
skvam/o	scale (fish etc.)
sled/o	sled, sledge, sleigh
slip/o	slip, card (for index)
smerald/o	emerald
sobr/a	sober
soci/o	social body, community
social/a	
societ/o	society
sociolog/o	sociologist
sociologi/o	sociology
sod/o	soda
sof/o	sofa
Sofi/o	
sofism/o	sophism
sofist/o	sophist
soif/i	thirst
sojl/o	threshold
sokl/o	
sol/a	only, alone
sold/o	halfpenny
soldat/o	soldier
sole/o	sole (fish)
solecism/o	
solen/a	solemn
solid/o	
solidar/a	jointly liable
solist/o	soloist
solv/i	dissolve  AK
solvent/a	solvent (fin.)
somer/o	summer
somnambul/o	somnambulist
son/i	sound (intr.)  AK
sonat/o	sonata
sond/i	to sound
sonet/o	sonnet
sonĝ/i	dream
sonor/o	give out a sound (as a bell)
sopir/i	long for, yearn  AK
sopran/o	soprano, treble  AK
sorb/i	absorb, sip  AK
sorĉ/i	practise witchcraft  AK
sorg/o	sorghum
sorik/o	shrew-mouse
sorp/o	sorb (sorb-apple)  AK
sort/o	fate, lot
sortiment/o	assortment
sovaĝ/a	wild, savage
spac/o	room, space
spad/o	sword
spalir/o	espalier
spasm/o	
spat/o	spar (min.)  AK
spec/o	kind, species
special/a	special
specif/i	
specimen/o	specimen
spegul/o	looking-glass
spekt/i	
spektakl/o	spectacle
spektr/o	
spekulaci/i	speculation
spekulativ/a	speculative
sperm/o	
spert/a	experienced  AK
spez/i	turnover (money), exchange  AK
spic/o	spice
spik/o	ear head (of corn, etc.)
spin/o	spine, back-bone
spinac/o	spinach
spion/o	spy (a)  AK
spir/i	breathe
spiral/o	spiral
spirit/o	spirit
spiritist/o	spiritist
spiritualism/o	
spiritualist/o	
spit/i	in spite of
splen/o	spleen
split/o	splinter
sponde/o	
spong/o	sponge
spontane/a	spontaneous
sport/o	sport
sprit/a	witty, quick-witted  AK
spron/o	spur
spur/o	spoor, footprint, track, trace, trail
sput/i	spit (blood, phlegm, etc.)  AK
stab/o	staff-officers
stabil/a	
stabl/o	trestle, workman’s bench  AK
staci/o	station, depot (railroad)  AK
stadi/o	stage
stadion/o	stadium
stagn/i	
stal/o	stall, shed, stable  AK
stalagmit/o	
stalaktit/o	
stamen/o	stamen (bot.)
stamp/o	stamp (with a die)  AK
stan/o	tin
standard/o	flag
stang/o	pole
star/i	stand
start/i	to start (in a race etc., intr.), 2.to start up (intr.)
stat/o	state, condition
statistik/o	statistics
statu/o	statue
statur/o	stature
statut/o	
stearin/o	stearine
steb/i	stitch (back) (vb.)  AK
Stefan/o	
stel/o	star
stenograf/i	to stenograph
stenografi/o	stenography
step/o	steppe, moor  AK
stereofoni/o	
sterk/o	dung, manure
sterled/o	sterlet (fish)
stern/i	spread out (on ground, etc.), lay  AK
stertor/o	to rattle (in the throat)  AK
stil/o	style
stimul/i	to stimulate
stip/o	feather-grass (stipa)  AK
stipendi/o	scholarship, study-allowance, bursary
stir/i	
stof/o	stofe (measure)
stoik/a	
stok/o	
stomak/o	stomach
stopl/o	stubble
strab/i	squint
strang/a	strange
strangol/i	
strat/o	street
strategi/o	
streb/i	to strive
streĉ/i	stretch, strain  AK
strek/o	make a line or stroke  AK
stri/o	stripe, band  AK
strig/o	owl
strigl/i	to curry-comb
strik/i	strike (labour)  AK
striknin/o	
strof/o	strophe, verse
struktur/o	structure
strut/o	ostrich
stud/i	study
student/o	student (of college etc.)  AK
stuk/i	stucco (vb.)  AK
stult/a	silly
stump/o	stump
stup/o	tow  AK
sturg/o	sturgeon
sturn/o	starling
subit/a	sudden
subjekt/o	subject (gram.)  AK
subjektiv/a	
subjunktiv/o	
sublimat/o	corrosive sublimate  AK
substanc/o	
substantiv/o	noun, substantive
subtil/a	subtle
subtrah/i	to subtract
subvenci/o	subvention, subsidy
suĉ/i	suck
sud/o	south
Sudan/o	
sufer/i	suffer
sufiĉ/a	sufficient
sufiks/o	suffix
suflor/o	prompter
sufok/i	suffocate (trans.)  AK
sugest/i	
sugesti/i	suggestion
suk/o	sap, juice
sukcen/o	amber
sukces/i	succeed  AK
suker/o	sugar
sulfur/o	sulphur
sulk/o	furrow
sultan/o	sultan
sum/o	sum
sun/o	sun
sup/o	soup
superlativ/o	superlative
superstiĉ/o	superstition
suplement/o	supplement
supoz/i	supose
supr/o	upper (adj.)
surd/a	deaf
surfac/o	surface
surpriz/i	surprise
surtut/o	overcoat  AK
suspekt/i	suspect
susur/i	to rustle
sutan/o	cassock
svarm/i	swarm
svat/i	act as matchmaker  AK
sved/o	
sven/i	faint, swoon  AK
sving/i	swing (trans.)  AK
ŝaf/o	sheep
ŝah/o	
ŝajn/i	seem
ŝak/o	chess
ŝakal/o	jackal
ŝal/o	shawl
ŝalm/o	reed-pipe  AK
ŝalt/i	
ŝalup/o	
ŝam/o	chamois-leather  AK
ŝanc/o	chance (possibility)
ŝancel/i	stagger, cause to totter (trans.)  AK
ŝanĝ/i	change
ŝankr/o	chancre
ŝarad/o	charade
ŝarg/i	load (a gun, etc.)
ŝarĝ/o	charge, load
ŝark/o	shark, sea-dog
ŝat/i	prize, value  AK
ŝaŭm/o	foam
ŝel/o	shell, peel, bark  AK
ŝelk/o	braces, suspenders  AK
ŝenopraz/o	
ŝerc/i	joke
ŝild/o	shield
ŝiling/o	shilling
Ŝiller/o	
ŝim/i	grow mouldy  AK
ŝind/o	shingle (roofing)  AK
ŝink/o	ham  AK
ŝip/o	ship
ŝir/i	tear, rend
ŝirm/i	protect, screen  AK
ŝlim/o	slime, mire, mud
ŝlos/i	lock, fasten
ŝmac/i	kiss loudly (with a smack)  AK
ŝmir/i	spread, smear  AK
ŝnur/o	string
ŝofor/o	chauffeur
ŝok/i	
ŝose/o	high road, made road
ŝov/i	thrust, shove  AK
ŝovel/i	shovel  AK
ŝovinism/o	chauvinism
ŝovinist/o	ultra-patriot
ŝpar/i	save, be sparing of  AK
ŝpat/o	spade
ŝpin/i	spin
ŝpruc/i	spirt, gush (intr.)  AK
ŝrank/o	cupboard
ŝrapnel/o	
ŝraŭb/o	screw
ŝrump/i	to shrivel, to shrink
ŝtal/o	steet
ŝtat/o	State
ŝtel/i	steal
ŝtip/o	block, log
ŝtof/o	stuff  AK
ŝton/o	stone
ŝtop/i	stop up, bung up  AK
ŝtorm/o	
ŝtrump/o	stocking
ŝtup/o	tow (subst.)  AK
ŝu/o	shoe
ŝuld/i	owe
ŝultr/o	shoulder  AK
ŝut/i	pour out (solids)  AK
ŝveb/i	to hover
ŝvel/i	swell
ŝvit/o	perspire
tabak/o	tobacco
taban/o	gad-fly
tabel/o	table, index
tabl/o	table
tabul/o	board, plank, tablet  AK
taburet/o	
taĉment/o	detachment (troops)  AK
taft/o	taffeta (material)  AK
tag/o	day
tajl/i	to cut, cut to shape; to form
tajlor/o	tailor
tajp/i	to type, to typewrite
taks/i	tax, appraise
taksi/o	
taksus/o	yew-tree
takt/o	tact
taktik/o	tactics
talent/o	talent
taler/o	thaler
tali/o	figure, waist, stature  AK
talisman/o	
talk/o	
talmud/o	
talp/o	mole (animal)
tambur/o	drum
tamburin/o	
tamtam/o	
tan/i	tan
tandem/o	
tangent/o	
tanin/o	tannin
tank/o	
tapet/o	wall-paper, paper-hangings  AK
tapiok/o	tapioca
tapir/o	
tapiŝ/o	carpet
tarantel/o	
tarantul/o	
tarif/o	tariff
tarok/o	
tas/o	cup
task/o	task
tatu/i	tatoo
taŭg/a	be fit for
tavol/o	layer, stratum  AK
te/o	tea
teatr/o	theatre
ted/i	bore, weary, annoy  AK
teg/i	cover (wholly) (vb.)  AK
tegment/o	roof
tegol/o	tile
teĥnik/o	technical
teism/o	
teist/o	
teknik/o	technical
teks/i	weave
tekst/o	text
telefon/o	telephone
telegraf/o	telegraph
telegram/o	telegram
telepati/o	
teler/o	plate
teleskop/o	
televid/i	to watch television
tem/o	theme, topic  AK
temp/o	time
temperament/o	temperament
temperatur/o	temperature
tempest/o	tempest
tempi/o	temple (of forehead)
templ/o	temple
ten/i	hold, grasp
tend/o	tent  AK
tenden/o	tendon
tendenc/o	tendency
tener/a	tender
teni/o	tape-worm
tenis/o	
tenor/o	tenor
tent/i	tempt  AK
Teodor/o	
teokrat/o	
teokrati/o	
teolog/o	theologian
teologi/o	theology
teorem/o	
teori/o	theory
ter/o	earth
terapi/o	therapeutics
teras/o	terrace
tercet/o	trio
terebint/o	turpentine
teren/o	ground, piece of land, terrain
teritori/o	
termin/o	term, technical name  AK
termit/oj	termite
termometr/o	thermometer
tern/i	sneeze
terur/o	terror, horror, fright  AK
test/o	
testament/o	will, testament  AK
testik/o	testicle
testud/o	tortoise
tetan/o	tetanus
tetr/o	grouse
tetra/o	hazel-hen
tez/o	thesis, proposition  AK
tiar/o	
tibi/o	shin bone
tif/o	typhus
tig/o	stem, stalk (of plant)
tigr/o	tiger
tikl/i	tickle
tili/o	lime-tree
tim/i	fear
timian/o	thyme
timon/o	shaft, pole  AK
tindr/o	tinder
tine/o	moth
tink/o	tench
tinktur/o	
tint/i	chink, clank, jingle
tip/o	type
tipograf/o	
tipografi/o	typography
tir/i	draw, pull, drag
tiran/o	tyrant
titan/o	Titan
titol/o	title
tog/o	
tol/o	linen (mat.)  AK
toler/i	tolerate
tomat/o	tomato
tomb/o	tomb, grave  AK
tombak/o	pinchbeck
ton/o	tone, sound
tond/i	clip, shear
tondr/o	thunder
tonel/o	ton (displacement)
tonsil/o	
tonsur/o	tonsure
topaz/o	topaz
topograf/o	
topografi/o	
torĉ/o	torch
tord/i	wind, twist
toreador/o	
torent/o	torrent
torf/o	peat, turf  AK
torn/i	turn (on a lathe)
tornistr/o	knapsack
torped/o	torpedo
tors/o	
tort/o	tart
tortur/i	
tost/o	toast
trab/o	beam (of wood)
tradici/o	tradition
traduk/i	translate
traf/i	hit the mark  AK
trafik/o	traffic
tragedi/o	tragedy
tragik/a	tragic
tragikomedi/o	tragi-comedy
traĥe/o	wind-pipe
trajn/o	1/2/3train
trajt/o	lineament, feature  AK
trakt/i	transact, treat of (a subject)  AK
traktat/o	treaty, treatise
traktor/o	tractor
tram/o	tram (rail); tram/veturil/o = tramcar; tram/voj/o = tramway
tranĉ/i	cut
trankvil/a	tranquil, quiet  AK
transept/o	
transistor/o	
transit/o	transit
transitiv/a	
trapez/o	
tref/o	clubs (at cards)  AK
trejn/i	to train
trem/i	tremble
tremol/o	aspen  AK
tremp/i	dip, steep
tren/i	drag, trail
tret/i	
trezor/o	treasure
trib/o	
tribun/o	orator’s pulpit
tribunal/o	tribunal
tribut/o	tribute
trigonometri/o	
trik/i	knit
trikot/o	stockinet (mat. for tights, jerseys, etc.)  AK
tril/o	trill
trink/i	drink
trip/o	tripe  AK
tritik/o	wheat
triumf/o	triumph
trivial/a	trivial
trofe/o	
trog/o	trough
tromb/o	water-spout
trombon/o	trombone
tromp/i	deceive, cheat
tron/o	throne
trop/o	
tropik/o	tropic
trot/i	trot
trotuar/o	pavement  AK
trov/i	find
tru/o	hole
trud/i	press upon, obtrude
truf/o	truffle
trul/o	trowel
trumpet/o	trumpet
trunk/o	trunk, stem
trup/o	troop
trust/o	
trut/o	trout
tualet/o	toilet
tub/o	tube
tuber/o	tuber, bump, swelling  AK
tuberkul/o	tubercle
tuberkuloz/o	tuberculosis
tuf/o	tuft
tuk/o	a cloth  AK
tukan/o	
tul/o	tulle
tulip/o	tulip
tumor/o	
tumult/o	tumult
tun/o	metric ton, tonne
tunel/o	tunnel
tunik/o	
Tunizi/o	
tur/o	tower
turb/o	whipping top
turban/o	turban
turbin/o	
turd/o	thrush
turism/o	touring
turist/o	tourist
turk/o	
turkis/o	turquoise
turment/i	torment
turn/i	turn (trans.)  AK
turnir/o	tournament  AK
turt/o	turtle-dove
tus/i	cough
tuŝ/i	touch
tut/a	whole, entire, total  AK
ukaz/o	
ulan/o	
ulcer/o	ulcer
ulm/o	elm
uln/o	ell (cloth measure)  AK
ultimat/o	
umbilik/o	navel
unc/o	ounce
ung/o	nail (finger)
uni/o	
uniform/o	uniform (dress)  AK
unik/a	unique
unison/o	unison
univers/o	universe
universal/a	universal
universitat/o	university
ur/o	ure-ox, wid-bull
uragan/o	hurricane
urb/o	town
urĝ/i	be urgent
urin/i	piss
urn/o	urn
urogal/o	wild cock
urs/o	bear (animal)
urtik/o	nettle
Urugvaj/o	
Uson/o	
uter/o	matrix (anat.), uterus  AK
util/a	useful  AK
utopi/o	utopia
uvertur/o	overture
uz/i	use, employ (vb.)  AK
uzur/o	usury
uzurp/i	usurp
vad/i	to wade, paddle
vafl/o	wafer (cake)  AK
vag/i	rove, wander about  AK
vagin/o	
vagon/o	carriage (railway)  AK
vak/i	be vacant
vakcin/o	vaccine
vakcini/o	vaccinium (vitisidaea)  AK
vaks/o	wax
vaku/o	
val/o	valley
valid/a	valid
valiz/o	valise
valor/o	be worth
vals/o	waltz
valut/o	
vampir/o	vampire
van/a	futile, vain  AK
vand/o	
vanel/o	lapwing
vang/o	cheek  AK
vanil/o	vanilla (spice)  AK
vant/a	frivolous, vain, empty  AK
vapor/o	vapour, steam  AK
var/o	wares, goods, commodities (noto)
varb/i	enlist, enrol  AK
vari/i	to vary
variant/o	
variol/o	smallpox
varm/a	warm
Varsovi/o	
vart/i	nurse, tend (children)  AK
vasal/o	vassal
vast/a	wide, vast
Vaŝington	
vat/o	wadding  AK
vaz/o	vessel, vase  AK
vazelin/o	
veget/i	vegetate
vegetal/o	plant (as opposed to animal)
vegetar/a	
vejn/o	vein
vek/i	wake, arouse (trans.)  AK
vekt/o	beam (of scales, balances, etc.)  AK
vel/o	sail (subst.)
velen/o	vellum
velk/i	fade
velociped/o	velocipede
velur/o	velvet
ven/i	come
vend/i	sell
vendred/o	Friday
venen/o	poison
Venezuel/o	
venĝ/i	take revenge, avenge  AK
venk/i	conquer
vent/o	wind (subst.)  AK
ventol/i	ventilate
ventr/o	belly
ver/a	truth  AK
verand/o	veranda
verb/o	verb
verben/o	vervain
verd/a	green
verdigr/o	verdigris
verdikt/o	verdict
verg/o	rod
verk/o	work (literary)
verm/o	worm
vermiĉel/o	vermicelli
vermut/o	
vers/o	verse
versi/o	
verst/o	verst
verŝ/i	pour
vert/o	top (of head), pate  AK
vertebr/o	vertebra  AK
vertic/o	vertex, apex (of an angle)
vertikal/o	vertical
veruk/o	wart
verv/o	animation
vesp/o	wasp
vesper/o	evening
vespert/oj	bat
vest/o	clothe
vestibl/o	lobby, vestibule  AK
veŝt/o	waistcoat  AK
vet/i	bet, wager
veter/o	weather
veteran/o	veteran
veterinar/o	veterinary
vetur/i	journey, travel
vezik/o	blister, bladder
vezir/o	visier
viadukt/o	
viand/o	meat, flesh
vibr/i	vibrate
viburn/o	guelder-rose, viburnum  AK
vic/o	row, rank
vid/i	see
vidv/o	widower
vigl/a	alert, spirited  AK
vikari/o	vicar, deputy  AK
viktim/o	victim
vil/a	rag, tuft
vilaĝ/o	village
Vilhelm/o	
vin/o	wine  AK
vinagr/o	vinegar
vind/o	swaddle, swathe  AK
vinjet/o	vignette
vink/o	periwinkle (bot.)
vinkt/o	rivet
vintr/o	winter
viol/o	violet (flower)  AK
violon/o	violin
violonĉel/o	violoncello
vip/o	whip
viper/o	viper
vipur/o	viper
vir/o	man, male  AK
virg/a	virginal
virt/o	virtue
virtual/a	
virtuoz/o	virtuoso
virus/o	
visk/o	mistletoe
viski/o	
vist/o	whist
viŝ/i	wipe
vit/o	vine
vitamin/o	
vitr/o	glass (substance)
vitriol/o	vitriol
viv/i	live
vivisekci/o	vivisection
viz/o	visa
vizaĝ/o	face
vizi/o	vision
vizier/o	visor
vizit/i	visit
voĉ/o	voice
vodk/o	
voj/o	way, road
vojaĝ/i	voyage
vok/i	call
vokal/o	vowel
vokativ/o	
vol/i	wish, will
volont/a	willingly
volum/o	volume
volumen/o	volume (geom.)
volupt/o	sensual pleasure
volv/i	wind, wrap round (trans.)  AK
vom/i	vomit
vort/o	word
vost/o	tail
vual/o	veil
vulgar/a	vulgar, common
vulkan/o	volcano  AK
vulp/o	fox
vultur/o	vulture  AK
vulv/o	
vund/o	wound
Zamenhof	
zebr/o	zebra
zefir/o	zephyr
zenit/o	zenith
zibel/o	sable
zigzag/o	zigzag
zingibr/o	ginger
zink/o	zinc
zip/o	
zizel/o	zizel (zool.)  AK
zodiak/o	zodiac
zon/o	belt, girdle  AK
zoolog/o	
zoologi/o	zoology
zorg/i	look after, see to  AK
zuav/o	zouave
zum/i	hum, buzz
